"","Year","Month","DOMESTIC","INTERNATIONAL","TOTAL","Company"
"1","2002",10,71507,12142,83649,"American Flights"
"2","2002",11,65868,11530,77398,"American Flights"
"3","2002",12,67672,12290,79962,"American Flights"
"4","2003",1,65960,12254,78214,"American Flights"
"5","2003",2,56960,10503,67463,"American Flights"
"6","2003",3,65168,11957,77125,"American Flights"
"7","2003",4,62117,11065,73182,"American Flights"
"8","2003",5,62611,10770,73381,"American Flights"
"9","2003",6,62115,11528,73643,"American Flights"
"10","2003",7,64980,12912,77892,"American Flights"
"11","2003",8,64236,12895,77131,"American Flights"
"12","2003",9,60134,11117,71251,"American Flights"
"13","2003",10,62989,11245,74234,"American Flights"
"14","2003",11,56146,11457,67603,"American Flights"
"15","2003",12,59292,12323,71615,"American Flights"
"16","2004",1,58732,12147,70879,"American Flights"
"17","2004",2,55969,11387,67356,"American Flights"
"18","2004",3,60276,12143,72419,"American Flights"
"19","2004",4,58345,11823,70168,"American Flights"
"20","2004",5,58058,11917,69975,"American Flights"
"21","2004",6,58002,12356,70358,"American Flights"
"22","2004",7,58843,13741,72584,"American Flights"
"23","2004",8,58920,13662,72582,"American Flights"
"24","2004",9,52464,10805,63269,"American Flights"
"25","2004",10,56305,11504,67809,"American Flights"
"26","2004",11,54869,11652,66521,"American Flights"
"27","2004",12,57650,12701,70351,"American Flights"
"28","2005",1,55726,12826,68552,"American Flights"
"29","2005",2,51555,11860,63415,"American Flights"
"30","2005",3,58185,13251,71436,"American Flights"
"31","2005",4,55573,12574,68147,"American Flights"
"32","2005",5,57145,12847,69992,"American Flights"
"33","2005",6,56984,13426,70410,"American Flights"
"34","2005",7,59168,14354,73522,"American Flights"
"35","2005",8,58124,13531,71655,"American Flights"
"36","2005",9,52814,11752,64566,"American Flights"
"37","2005",10,53325,11464,64789,"American Flights"
"38","2005",11,53344,11476,64820,"American Flights"
"39","2005",12,54072,12518,66590,"American Flights"
"40","2006",1,54210,12882,67092,"American Flights"
"41","2006",2,48771,11699,60470,"American Flights"
"42","2006",3,55481,13207,68688,"American Flights"
"43","2006",4,53271,12715,65986,"American Flights"
"44","2006",5,55002,13029,68031,"American Flights"
"45","2006",6,53404,12913,66317,"American Flights"
"46","2006",7,54287,13520,67807,"American Flights"
"47","2006",8,54654,13327,67981,"American Flights"
"48","2006",9,50982,11802,62784,"American Flights"
"49","2006",10,52849,11951,64800,"American Flights"
"50","2006",11,50264,11348,61612,"American Flights"
"51","2006",12,52526,12715,65241,"American Flights"
"52","2007",1,52739,12980,65719,"American Flights"
"53","2007",2,46687,11365,58052,"American Flights"
"54","2007",3,53432,12875,66307,"American Flights"
"55","2007",4,50822,12487,63309,"American Flights"
"56","2007",5,52800,12677,65477,"American Flights"
"57","2007",6,50597,12350,62947,"American Flights"
"58","2007",7,53125,12979,66104,"American Flights"
"59","2007",8,53110,12905,66015,"American Flights"
"60","2007",9,50533,11496,62029,"American Flights"
"61","2007",10,53086,11624,64710,"American Flights"
"62","2007",11,50747,11406,62153,"American Flights"
"63","2007",12,50937,12624,63561,"American Flights"
"64","2008",1,50905,12736,63641,"American Flights"
"65","2008",2,46513,11643,58156,"American Flights"
"66","2008",3,49437,12415,61852,"American Flights"
"67","2008",4,47765,11968,59733,"American Flights"
"68","2008",5,52310,12518,64828,"American Flights"
"69","2008",6,50175,12118,62293,"American Flights"
"70","2008",7,52392,12766,65158,"American Flights"
"71","2008",8,52247,12859,65106,"American Flights"
"72","2008",9,47601,10566,58167,"American Flights"
"73","2008",10,49556,10890,60446,"American Flights"
"74","2008",11,44537,11402,55939,"American Flights"
"75","2008",12,46472,11961,58433,"American Flights"
"76","2009",1,46183,12066,58249,"American Flights"
"77","2009",2,42031,10654,52685,"American Flights"
"78","2009",3,46938,11892,58830,"American Flights"
"79","2009",4,45069,11499,56568,"American Flights"
"80","2009",5,46198,11425,57623,"American Flights"
"81","2009",6,45168,11418,56586,"American Flights"
"82","2009",7,47268,12098,59366,"American Flights"
"83","2009",8,47151,11727,58878,"American Flights"
"84","2009",9,44007,10037,54044,"American Flights"
"85","2009",10,45514,10497,56011,"American Flights"
"86","2009",11,43619,10662,54281,"American Flights"
"87","2009",12,45131,11927,57058,"American Flights"
"88","2010",1,45545,11842,57387,"American Flights"
"89","2010",2,40142,10529,50671,"American Flights"
"90","2010",3,46963,12095,59058,"American Flights"
"91","2010",4,44521,11532,56053,"American Flights"
"92","2010",5,44949,12299,57248,"American Flights"
"93","2010",6,44173,12307,56480,"American Flights"
"94","2010",7,46117,13282,59399,"American Flights"
"95","2010",8,46122,12799,58921,"American Flights"
"96","2010",9,43268,10957,54225,"American Flights"
"97","2010",10,44396,11478,55874,"American Flights"
"98","2010",11,43094,11233,54327,"American Flights"
"99","2010",12,44697,12230,56927,"American Flights"
"100","2011",1,44782,12562,57344,"American Flights"
"101","2011",2,39189,11181,50370,"American Flights"
"102","2011",3,46034,12423,58457,"American Flights"
"103","2011",4,44236,11758,55994,"American Flights"
"104","2011",5,43937,12071,56008,"American Flights"
"105","2011",6,44959,12285,57244,"American Flights"
"106","2011",7,46435,13139,59574,"American Flights"
"107","2011",8,45552,12327,57879,"American Flights"
"108","2011",9,43411,10737,54148,"American Flights"
"109","2011",10,44337,11147,55484,"American Flights"
"110","2011",11,41353,10891,52244,"American Flights"
"111","2011",12,42745,12449,55194,"American Flights"
"112","2012",1,43139,12567,55706,"American Flights"
"113","2012",2,41446,11652,53098,"American Flights"
"114","2012",3,45567,12451,58018,"American Flights"
"115","2012",4,42425,11566,53991,"American Flights"
"116","2012",5,45084,12039,57123,"American Flights"
"117","2012",6,43178,12085,55263,"American Flights"
"118","2012",7,44515,13115,57630,"American Flights"
"119","2012",8,44018,12313,56331,"American Flights"
"120","2012",9,40677,10998,51675,"American Flights"
"121","2012",10,42071,11399,53470,"American Flights"
"122","2012",11,41689,11659,53348,"American Flights"
"123","2012",12,44037,12988,57025,"American Flights"
"124","2013",1,44107,12785,56892,"American Flights"
"125","2013",2,40076,11567,51643,"American Flights"
"126","2013",3,45332,13100,58432,"American Flights"
"127","2013",4,43469,12082,55551,"American Flights"
"128","2013",5,45433,12601,58034,"American Flights"
"129","2013",6,44895,12973,57868,"American Flights"
"130","2013",7,46654,13895,60549,"American Flights"
"131","2013",8,46595,13539,60134,"American Flights"
"132","2013",9,42986,11159,54145,"American Flights"
"133","2013",10,45244,11557,56801,"American Flights"
"134","2013",11,42619,11679,54298,"American Flights"
"135","2013",12,42876,13414,56290,"American Flights"
"136","2014",1,43978,13427,57405,"American Flights"
"137","2014",2,39248,11914,51162,"American Flights"
"138","2014",3,45537,13526,59063,"American Flights"
"139","2014",4,43630,12877,56507,"American Flights"
"140","2014",5,44916,13085,58001,"American Flights"
"141","2014",6,45663,13436,59099,"American Flights"
"142","2014",7,47130,14057,61187,"American Flights"
"143","2014",8,45957,13098,59055,"American Flights"
"144","2014",9,43110,10995,54105,"American Flights"
"145","2014",10,44856,11253,56109,"American Flights"
"146","2014",11,42397,11996,54393,"American Flights"
"147","2014",12,45150,13324,58474,"American Flights"
"148","2015",1,43287,12960,56247,"American Flights"
"149","2015",2,37396,11417,48813,"American Flights"
"150","2015",3,44655,12867,57522,"American Flights"
"151","2015",4,44663,12144,56807,"American Flights"
"152","2015",5,44065,12673,56738,"American Flights"
"153","2015",6,44042,13401,57443,"American Flights"
"154","2015",7,81130,19027,100157,"American Flights"
"155","2015",8,79263,17877,97140,"American Flights"
"156","2015",9,73187,14636,87823,"American Flights"
"157","2015",10,76790,14893,91683,"American Flights"
"158","2015",11,73572,14795,88367,"American Flights"
"159","2015",12,75602,17065,92667,"American Flights"
"160","2016",1,73096,16163,89259,"American Flights"
"161","2016",2,70596,14975,85571,"American Flights"
"162","2016",3,78887,17062,95949,"American Flights"
"163","2016",4,74412,16328,90740,"American Flights"
"164","2016",5,78480,16373,94853,"American Flights"
"165","2016",6,79164,17298,96462,"American Flights"
"166","2016",7,80654,18349,99003,"American Flights"
"167","2016",8,79138,16910,96048,"American Flights"
"168","2016",9,72358,13707,86065,"American Flights"
"169","2016",10,74458,14167,88625,"American Flights"
"170","2016",11,71727,13751,85478,"American Flights"
"171","2016",12,73393,16764,90157,"American Flights"
"172","2017",1,72378,15749,88127,"American Flights"
"173","2017",2,66463,14055,80518,"American Flights"
"174","2017",3,77089,16526,93615,"American Flights"
"175","2017",4,73099,16651,89750,"American Flights"
"176","2017",5,77011,17295,94306,"American Flights"
"177","2017",6,76142,17932,94074,"American Flights"
"178","2017",7,78311,18891,97202,"American Flights"
"179","2017",8,78553,17568,96121,"American Flights"
"180","2017",9,68928,12778,81706,"American Flights"
"181","2017",10,75559,15007,90566,"American Flights"
"182","2017",11,69689,14062,83751,"American Flights"
"183","2017",12,73581,16631,90212,"American Flights"
"184","2018",1,72293,15612,87905,"American Flights"
"185","2018",2,67711,14307,82018,"American Flights"
"186","2018",3,75893,16863,92756,"American Flights"
"187","2018",4,74118,16567,90685,"American Flights"
"188","2018",5,77253,17133,94386,"American Flights"
"189","2018",6,77266,17672,94938,"American Flights"
"190","2018",7,79177,18423,97600,"American Flights"
"191","2018",8,79351,17185,96536,"American Flights"
"192","2018",9,73948,14136,88084,"American Flights"
"193","2018",10,78497,14896,93393,"American Flights"
"194","2018",11,74178,13765,87943,"American Flights"
"195","2018",12,74942,16032,90974,"American Flights"
"196","2019",1,75689,15696,91385,"American Flights"
"197","2019",2,70375,14260,84635,"American Flights"
"198","2019",3,78429,16242,94671,"American Flights"
"199","2019",4,74375,15005,89380,"American Flights"
"200","2019",5,79177,16118,95295,"American Flights"
"201","2019",6,76831,17467,94298,"American Flights"
"202","2019",7,79663,18393,98056,"American Flights"
"203","2019",8,81137,17354,98491,"American Flights"
"204","2019",9,76641,13547,90188,"American Flights"
"205","2019",10,80362,13848,94210,"American Flights"
"206","2019",11,77277,12855,90132,"American Flights"
"207","2019",12,79378,14908,94286,"American Flights"
"208","2020",1,75742,15157,90899,"American Flights"
"209","2020",2,71794,14206,86000,"American Flights"
"210","2020",3,65150,10554,75704,"American Flights"
"211","2020",4,25873,1458,27331,"American Flights"
"212","2020",5,21927,1555,23482,"American Flights"
"213","2020",6,27099,2507,29606,"American Flights"
"214","2020",7,45989,3992,49981,"American Flights"
"215","2020",8,46767,4099,50866,"American Flights"
"216","2020",9,38838,4394,43232,"American Flights"
"217","2020",10,40682,5876,46558,"American Flights"
"218","2020",11,38501,7756,46257,"American Flights"
"219","2020",12,38367,9386,47753,"American Flights"
"220","2021",1,38036,10582,48618,"American Flights"
"221","2021",2,32194,10337,42531,"American Flights"
"222","2021",3,47456,13527,60983,"American Flights"
"223","2021",4,52084,12959,65043,"American Flights"
"224","2021",5,60722,12512,73234,"American Flights"
"225","2021",6,68328,12761,81089,"American Flights"
"226","2021",7,72137,13554,85691,"American Flights"
"227","2021",8,70322,11842,82164,"American Flights"
"228","2021",9,66951,9883,76834,"American Flights"
"229","2021",10,70831,11002,81833,"American Flights"
"230","2021",11,71672,12263,83935,"American Flights"
"231","2021",12,71509,14681,86190,"American Flights"
"232","2022",1,66576,14723,81299,"American Flights"
"233","2022",2,59640,13233,72873,"American Flights"
"234","2022",3,70716,16263,86979,"American Flights"
"235","2022",4,66053,16670,82723,"American Flights"
"236","2022",5,70767,17478,88245,"American Flights"
"237","2022",6,70625,17930,88555,"American Flights"
"238","2022",7,74436,18848,93284,"American Flights"
"239","2022",8,75439,18062,93501,"American Flights"
"240","2022",9,71105,15438,86543,"American Flights"
"241","2022",10,77192,16045,93237,"American Flights"
"242","2022",11,73285,16631,89916,"American Flights"
"243","2022",12,75174,18538,93712,"American Flights"
"244","2023",1,73744,17888,91632,"American Flights"
"245","2023",2,69959,16370,86329,"American Flights"
"246","2023",3,78111,18652,96763,"American Flights"
"247","2023",4,76109,17488,93597,"American Flights"
"248","2023",5,79631,17628,97259,"American Flights"
"249","2023",6,79962,18196,98158,"American Flights"
"250","2023",7,81985,19170,101155,"American Flights"
"251","2023",8,84290,18552,102842,"American Flights"
"252","2023",9,76626,14995,91621,"American Flights"
"253","2023",10,81062,16112,97174,"American Flights"
"254","2023",11,76478,16603,93081,"American Flights"
"255","2023",12,75523,19274,94797,"American Flights"
"256","2024",1,76326,19384,95710,"American Flights"
"257","2024",2,74881,18067,92948,"American Flights"
"258","2024",3,81670,19798,101468,"American Flights"
"259","2024",4,80674,18385,99059,"American Flights"
"260","2024",5,84291,19028,103319,"American Flights"
"261","2024",6,84064,19654,103718,"American Flights"
"262","2024",7,86522,20202,106724,"American Flights"
"263","2024",8,83875,18894,102769,"American Flights"
"264","2024",9,80306,14076,94382,"American Flights"
"265","2024",10,86156,15275,101431,"American Flights"
"266","2024",11,76439,16365,92804,"American Flights"
"267","2024",12,77271,18986,96257,"American Flights"
"268","2025",1,72517,18220,90737,"American Flights"
"269","2002",10,2865,NA,2865,"Spirit Flights"
"270","2002",11,3049,NA,3049,"Spirit Flights"
"271","2002",12,3305,NA,3305,"Spirit Flights"
"272","2003",1,3223,NA,3223,"Spirit Flights"
"273","2003",2,2910,NA,2910,"Spirit Flights"
"274","2003",3,3347,NA,3347,"Spirit Flights"
"275","2003",4,3299,NA,3299,"Spirit Flights"
"276","2003",5,2590,NA,2590,"Spirit Flights"
"277","2003",6,2666,NA,2666,"Spirit Flights"
"278","2003",7,3082,NA,3082,"Spirit Flights"
"279","2003",8,3055,NA,3055,"Spirit Flights"
"280","2003",9,2369,NA,2369,"Spirit Flights"
"281","2003",10,2600,8,2608,"Spirit Flights"
"282","2003",11,2955,NA,2955,"Spirit Flights"
"283","2003",12,3526,28,3554,"Spirit Flights"
"284","2004",1,3468,61,3529,"Spirit Flights"
"285","2004",2,3311,58,3369,"Spirit Flights"
"286","2004",3,3594,62,3656,"Spirit Flights"
"287","2004",4,3565,60,3625,"Spirit Flights"
"288","2004",5,3283,62,3345,"Spirit Flights"
"289","2004",6,3312,80,3392,"Spirit Flights"
"290","2004",7,3720,110,3830,"Spirit Flights"
"291","2004",8,3450,102,3552,"Spirit Flights"
"292","2004",9,2483,54,2537,"Spirit Flights"
"293","2004",10,2840,62,2902,"Spirit Flights"
"294","2004",11,3299,85,3384,"Spirit Flights"
"295","2004",12,3715,189,3904,"Spirit Flights"
"296","2005",1,3513,216,3729,"Spirit Flights"
"297","2005",2,3481,209,3690,"Spirit Flights"
"298","2005",3,3618,248,3866,"Spirit Flights"
"299","2005",4,3538,286,3824,"Spirit Flights"
"300","2005",5,2864,308,3172,"Spirit Flights"
"301","2005",6,2913,334,3247,"Spirit Flights"
"302","2005",7,3326,448,3774,"Spirit Flights"
"303","2005",8,2915,345,3260,"Spirit Flights"
"304","2005",9,2186,234,2420,"Spirit Flights"
"305","2005",10,2210,191,2401,"Spirit Flights"
"306","2005",11,2534,333,2867,"Spirit Flights"
"307","2005",12,2795,553,3348,"Spirit Flights"
"308","2006",1,2867,595,3462,"Spirit Flights"
"309","2006",2,2674,587,3261,"Spirit Flights"
"310","2006",3,3268,665,3933,"Spirit Flights"
"311","2006",4,3131,645,3776,"Spirit Flights"
"312","2006",5,2708,493,3201,"Spirit Flights"
"313","2006",6,2810,604,3414,"Spirit Flights"
"314","2006",7,3164,665,3829,"Spirit Flights"
"315","2006",8,3130,562,3692,"Spirit Flights"
"316","2006",9,2796,428,3224,"Spirit Flights"
"317","2006",10,2867,430,3297,"Spirit Flights"
"318","2006",11,2997,468,3465,"Spirit Flights"
"319","2006",12,3374,688,4062,"Spirit Flights"
"320","2007",1,3410,667,4077,"Spirit Flights"
"321","2007",2,3654,717,4371,"Spirit Flights"
"322","2007",3,4285,840,5125,"Spirit Flights"
"323","2007",4,4270,860,5130,"Spirit Flights"
"324","2007",5,3728,864,4592,"Spirit Flights"
"325","2007",6,3973,1316,5289,"Spirit Flights"
"326","2007",7,4283,1412,5695,"Spirit Flights"
"327","2007",8,4023,1293,5316,"Spirit Flights"
"328","2007",9,3435,860,4295,"Spirit Flights"
"329","2007",10,3575,805,4380,"Spirit Flights"
"330","2007",11,3783,900,4683,"Spirit Flights"
"331","2007",12,4087,1185,5272,"Spirit Flights"
"332","2008",1,4065,1035,5100,"Spirit Flights"
"333","2008",2,4016,883,4899,"Spirit Flights"
"334","2008",3,4569,966,5535,"Spirit Flights"
"335","2008",4,4280,941,5221,"Spirit Flights"
"336","2008",5,4288,1167,5455,"Spirit Flights"
"337","2008",6,4431,1302,5733,"Spirit Flights"
"338","2008",7,4524,1362,5886,"Spirit Flights"
"339","2008",8,3952,1206,5158,"Spirit Flights"
"340","2008",9,3269,863,4132,"Spirit Flights"
"341","2008",10,3295,859,4154,"Spirit Flights"
"342","2008",11,3363,797,4160,"Spirit Flights"
"343","2008",12,3613,850,4463,"Spirit Flights"
"344","2009",1,3395,865,4260,"Spirit Flights"
"345","2009",2,3216,790,4006,"Spirit Flights"
"346","2009",3,3832,942,4774,"Spirit Flights"
"347","2009",4,3547,858,4405,"Spirit Flights"
"348","2009",5,3571,1048,4619,"Spirit Flights"
"349","2009",6,3484,1062,4546,"Spirit Flights"
"350","2009",7,3676,1179,4855,"Spirit Flights"
"351","2009",8,3637,1128,4765,"Spirit Flights"
"352","2009",9,3442,697,4139,"Spirit Flights"
"353","2009",10,3581,744,4325,"Spirit Flights"
"354","2009",11,3543,753,4296,"Spirit Flights"
"355","2009",12,3659,865,4524,"Spirit Flights"
"356","2010",1,3498,843,4341,"Spirit Flights"
"357","2010",2,3071,767,3838,"Spirit Flights"
"358","2010",3,3794,940,4734,"Spirit Flights"
"359","2010",4,3808,916,4724,"Spirit Flights"
"360","2010",5,3922,922,4844,"Spirit Flights"
"361","2010",6,3115,791,3906,"Spirit Flights"
"362","2010",7,4146,1206,5352,"Spirit Flights"
"363","2010",8,4089,1090,5179,"Spirit Flights"
"364","2010",9,3821,864,4685,"Spirit Flights"
"365","2010",10,4073,864,4937,"Spirit Flights"
"366","2010",11,3963,955,4918,"Spirit Flights"
"367","2010",12,3924,1126,5050,"Spirit Flights"
"368","2011",1,3840,1040,4880,"Spirit Flights"
"369","2011",2,3585,826,4411,"Spirit Flights"
"370","2011",3,4535,912,5447,"Spirit Flights"
"371","2011",4,4533,900,5433,"Spirit Flights"
"372","2011",5,4882,842,5724,"Spirit Flights"
"373","2011",6,4712,878,5590,"Spirit Flights"
"374","2011",7,5027,1084,6111,"Spirit Flights"
"375","2011",8,4842,1037,5879,"Spirit Flights"
"376","2011",9,4469,692,5161,"Spirit Flights"
"377","2011",10,4717,646,5363,"Spirit Flights"
"378","2011",11,4757,743,5500,"Spirit Flights"
"379","2011",12,5093,843,5936,"Spirit Flights"
"380","2012",1,4913,851,5764,"Spirit Flights"
"381","2012",2,4776,791,5567,"Spirit Flights"
"382","2012",3,5806,822,6628,"Spirit Flights"
"383","2012",4,5649,811,6460,"Spirit Flights"
"384","2012",5,5637,838,6475,"Spirit Flights"
"385","2012",6,5801,872,6673,"Spirit Flights"
"386","2012",7,6179,980,7159,"Spirit Flights"
"387","2012",8,6218,951,7169,"Spirit Flights"
"388","2012",9,5631,737,6368,"Spirit Flights"
"389","2012",10,5642,645,6287,"Spirit Flights"
"390","2012",11,5850,770,6620,"Spirit Flights"
"391","2012",12,6074,854,6928,"Spirit Flights"
"392","2013",1,5957,822,6779,"Spirit Flights"
"393","2013",2,5679,740,6419,"Spirit Flights"
"394","2013",3,6676,830,7506,"Spirit Flights"
"395","2013",4,6547,793,7340,"Spirit Flights"
"396","2013",5,6846,859,7705,"Spirit Flights"
"397","2013",6,6732,978,7710,"Spirit Flights"
"398","2013",7,7163,1087,8250,"Spirit Flights"
"399","2013",8,7120,1059,8179,"Spirit Flights"
"400","2013",9,6547,637,7184,"Spirit Flights"
"401","2013",10,6716,629,7345,"Spirit Flights"
"402","2013",11,6797,817,7614,"Spirit Flights"
"403","2013",12,6992,842,7834,"Spirit Flights"
"404","2014",1,7038,890,7928,"Spirit Flights"
"405","2014",2,6446,808,7254,"Spirit Flights"
"406","2014",3,7373,893,8266,"Spirit Flights"
"407","2014",4,7263,861,8124,"Spirit Flights"
"408","2014",5,7612,1044,8656,"Spirit Flights"
"409","2014",6,7466,1008,8474,"Spirit Flights"
"410","2014",7,7747,1042,8789,"Spirit Flights"
"411","2014",8,8195,1049,9244,"Spirit Flights"
"412","2014",9,7803,614,8417,"Spirit Flights"
"413","2014",10,8089,602,8691,"Spirit Flights"
"414","2014",11,8170,835,9005,"Spirit Flights"
"415","2014",12,8410,930,9340,"Spirit Flights"
"416","2015",1,8771,995,9766,"Spirit Flights"
"417","2015",2,8031,852,8883,"Spirit Flights"
"418","2015",3,9303,940,10243,"Spirit Flights"
"419","2015",4,9459,952,10411,"Spirit Flights"
"420","2015",5,9864,1096,10960,"Spirit Flights"
"421","2015",6,9388,1178,10566,"Spirit Flights"
"422","2015",7,10255,1282,11537,"Spirit Flights"
"423","2015",8,10276,1276,11552,"Spirit Flights"
"424","2015",9,9897,863,10760,"Spirit Flights"
"425","2015",10,10194,739,10933,"Spirit Flights"
"426","2015",11,10086,920,11006,"Spirit Flights"
"427","2015",12,10520,1028,11548,"Spirit Flights"
"428","2016",1,10765,1058,11823,"Spirit Flights"
"429","2016",2,9985,965,10950,"Spirit Flights"
"430","2016",3,11108,1051,12159,"Spirit Flights"
"431","2016",4,11262,1135,12397,"Spirit Flights"
"432","2016",5,11856,1185,13041,"Spirit Flights"
"433","2016",6,11375,1143,12518,"Spirit Flights"
"434","2016",7,11791,1197,12988,"Spirit Flights"
"435","2016",8,11835,1190,13025,"Spirit Flights"
"436","2016",9,11118,897,12015,"Spirit Flights"
"437","2016",10,11231,798,12029,"Spirit Flights"
"438","2016",11,11573,866,12439,"Spirit Flights"
"439","2016",12,12153,1033,13186,"Spirit Flights"
"440","2017",1,12160,1024,13184,"Spirit Flights"
"441","2017",2,11276,946,12222,"Spirit Flights"
"442","2017",3,12583,1042,13625,"Spirit Flights"
"443","2017",4,12343,1047,13390,"Spirit Flights"
"444","2017",5,12587,1198,13785,"Spirit Flights"
"445","2017",6,12976,1106,14082,"Spirit Flights"
"446","2017",7,13838,1150,14988,"Spirit Flights"
"447","2017",8,13817,1119,14936,"Spirit Flights"
"448","2017",9,11594,726,12320,"Spirit Flights"
"449","2017",10,13018,847,13865,"Spirit Flights"
"450","2017",11,12770,960,13730,"Spirit Flights"
"451","2017",12,13059,1055,14114,"Spirit Flights"
"452","2018",1,13837,1142,14979,"Spirit Flights"
"453","2018",2,12818,1039,13857,"Spirit Flights"
"454","2018",3,14618,1179,15797,"Spirit Flights"
"455","2018",4,14492,1363,15855,"Spirit Flights"
"456","2018",5,14852,1485,16337,"Spirit Flights"
"457","2018",6,15421,1499,16920,"Spirit Flights"
"458","2018",7,16028,1538,17566,"Spirit Flights"
"459","2018",8,15972,1530,17502,"Spirit Flights"
"460","2018",9,13477,1121,14598,"Spirit Flights"
"461","2018",10,13808,1255,15063,"Spirit Flights"
"462","2018",11,14401,1523,15924,"Spirit Flights"
"463","2018",12,15021,1749,16770,"Spirit Flights"
"464","2019",1,15079,1871,16950,"Spirit Flights"
"465","2019",2,14040,1710,15750,"Spirit Flights"
"466","2019",3,17092,2012,19104,"Spirit Flights"
"467","2019",4,16405,1931,18336,"Spirit Flights"
"468","2019",5,17898,2109,20007,"Spirit Flights"
"469","2019",6,17647,2070,19717,"Spirit Flights"
"470","2019",7,18529,2118,20647,"Spirit Flights"
"471","2019",8,18358,2101,20459,"Spirit Flights"
"472","2019",9,16004,1565,17569,"Spirit Flights"
"473","2019",10,16837,1653,18490,"Spirit Flights"
"474","2019",11,17376,1777,19153,"Spirit Flights"
"475","2019",12,17237,1845,19082,"Spirit Flights"
"476","2020",1,17368,1851,19219,"Spirit Flights"
"477","2020",2,17334,1690,19024,"Spirit Flights"
"478","2020",3,18301,1299,19600,"Spirit Flights"
"479","2020",4,4433,23,4456,"Spirit Flights"
"480","2020",5,1425,42,1467,"Spirit Flights"
"481","2020",6,4415,110,4525,"Spirit Flights"
"482","2020",7,16034,642,16676,"Spirit Flights"
"483","2020",8,11551,553,12104,"Spirit Flights"
"484","2020",9,7487,664,8151,"Spirit Flights"
"485","2020",10,9134,1148,10282,"Spirit Flights"
"486","2020",11,12288,1253,13541,"Spirit Flights"
"487","2020",12,12631,1616,14247,"Spirit Flights"
"488","2021",1,11115,1691,12806,"Spirit Flights"
"489","2021",2,9777,1334,11111,"Spirit Flights"
"490","2021",3,14652,1248,15900,"Spirit Flights"
"491","2021",4,14794,1271,16065,"Spirit Flights"
"492","2021",5,17063,1899,18962,"Spirit Flights"
"493","2021",6,16586,2076,18662,"Spirit Flights"
"494","2021",7,18762,2541,21303,"Spirit Flights"
"495","2021",8,16232,2342,18574,"Spirit Flights"
"496","2021",9,16588,2332,18920,"Spirit Flights"
"497","2021",10,16638,2538,19176,"Spirit Flights"
"498","2021",11,17358,2659,20017,"Spirit Flights"
"499","2021",12,17149,3134,20283,"Spirit Flights"
"500","2022",1,16993,2768,19761,"Spirit Flights"
"501","2022",2,16216,2578,18794,"Spirit Flights"
"502","2022",3,18947,2965,21912,"Spirit Flights"
"503","2022",4,16843,2807,19650,"Spirit Flights"
"504","2022",5,18727,3065,21792,"Spirit Flights"
"505","2022",6,18382,2762,21144,"Spirit Flights"
"506","2022",7,19368,2839,22207,"Spirit Flights"
"507","2022",8,19456,2831,22287,"Spirit Flights"
"508","2022",9,19459,2556,22015,"Spirit Flights"
"509","2022",10,20852,2708,23560,"Spirit Flights"
"510","2022",11,20566,2647,23213,"Spirit Flights"
"511","2022",12,20273,3017,23290,"Spirit Flights"
"512","2023",1,21402,3107,24509,"Spirit Flights"
"513","2023",2,19947,2705,22652,"Spirit Flights"
"514","2023",3,22266,2957,25223,"Spirit Flights"
"515","2023",4,22012,2861,24873,"Spirit Flights"
"516","2023",5,22413,3239,25652,"Spirit Flights"
"517","2023",6,20603,3237,23840,"Spirit Flights"
"518","2023",7,20822,3391,24213,"Spirit Flights"
"519","2023",8,21315,3186,24501,"Spirit Flights"
"520","2023",9,20794,2721,23515,"Spirit Flights"
"521","2023",10,22956,2761,25717,"Spirit Flights"
"522","2023",11,23095,2764,25859,"Spirit Flights"
"523","2023",12,22508,3200,25708,"Spirit Flights"
"524","2024",1,20148,3232,23380,"Spirit Flights"
"525","2024",2,19823,2894,22717,"Spirit Flights"
"526","2024",3,22538,2914,25452,"Spirit Flights"
"527","2024",4,21805,2590,24395,"Spirit Flights"
"528","2024",5,23140,2593,25733,"Spirit Flights"
"529","2024",6,22930,2409,25339,"Spirit Flights"
"530","2024",7,23562,2262,25824,"Spirit Flights"
"531","2024",8,23768,2215,25983,"Spirit Flights"
"532","2024",9,20180,1936,22116,"Spirit Flights"
"533","2024",10,20779,1903,22682,"Spirit Flights"
"534","2024",11,19420,1814,21234,"Spirit Flights"
"535","2024",12,18590,2770,21360,"Spirit Flights"
"536","2025",1,17004,2459,19463,"Spirit Flights"
"537","2002",10,81876,NA,81876,"SouthWest Flights"
"538","2002",11,76818,NA,76818,"SouthWest Flights"
"539","2002",12,79481,NA,79481,"SouthWest Flights"
"540","2003",1,80620,NA,80620,"SouthWest Flights"
"541","2003",2,72108,NA,72108,"SouthWest Flights"
"542","2003",3,80362,NA,80362,"SouthWest Flights"
"543","2003",4,78676,NA,78676,"SouthWest Flights"
"544","2003",5,79998,NA,79998,"SouthWest Flights"
"545","2003",6,78862,NA,78862,"SouthWest Flights"
"546","2003",7,81282,NA,81282,"SouthWest Flights"
"547","2003",8,80940,NA,80940,"SouthWest Flights"
"548","2003",9,78702,NA,78702,"SouthWest Flights"
"549","2003",10,81970,NA,81970,"SouthWest Flights"
"550","2003",11,76596,NA,76596,"SouthWest Flights"
"551","2003",12,79822,NA,79822,"SouthWest Flights"
"552","2004",1,79508,NA,79508,"SouthWest Flights"
"553","2004",2,76342,NA,76342,"SouthWest Flights"
"554","2004",3,82634,NA,82634,"SouthWest Flights"
"555","2004",4,79876,NA,79876,"SouthWest Flights"
"556","2004",5,81437,NA,81437,"SouthWest Flights"
"557","2004",6,81100,NA,81100,"SouthWest Flights"
"558","2004",7,83700,NA,83700,"SouthWest Flights"
"559","2004",8,84944,NA,84944,"SouthWest Flights"
"560","2004",9,80357,NA,80357,"SouthWest Flights"
"561","2004",10,85083,NA,85083,"SouthWest Flights"
"562","2004",11,81138,NA,81138,"SouthWest Flights"
"563","2004",12,85555,NA,85555,"SouthWest Flights"
"564","2005",1,84320,NA,84320,"SouthWest Flights"
"565","2005",2,77736,NA,77736,"SouthWest Flights"
"566","2005",3,87097,NA,87097,"SouthWest Flights"
"567","2005",4,84345,NA,84345,"SouthWest Flights"
"568","2005",5,87625,NA,87625,"SouthWest Flights"
"569","2005",6,86364,NA,86364,"SouthWest Flights"
"570","2005",7,88481,NA,88481,"SouthWest Flights"
"571","2005",8,89712,NA,89712,"SouthWest Flights"
"572","2005",9,83745,NA,83745,"SouthWest Flights"
"573","2005",10,87122,NA,87122,"SouthWest Flights"
"574","2005",11,84104,NA,84104,"SouthWest Flights"
"575","2005",12,88152,NA,88152,"SouthWest Flights"
"576","2006",1,89547,NA,89547,"SouthWest Flights"
"577","2006",2,81336,NA,81336,"SouthWest Flights"
"578","2006",3,91567,NA,91567,"SouthWest Flights"
"579","2006",4,88619,NA,88619,"SouthWest Flights"
"580","2006",5,91855,NA,91855,"SouthWest Flights"
"581","2006",6,90475,NA,90475,"SouthWest Flights"
"582","2006",7,93312,NA,93312,"SouthWest Flights"
"583","2006",8,95199,NA,95199,"SouthWest Flights"
"584","2006",9,90528,NA,90528,"SouthWest Flights"
"585","2006",10,95524,NA,95524,"SouthWest Flights"
"586","2006",11,91210,NA,91210,"SouthWest Flights"
"587","2006",12,93171,NA,93171,"SouthWest Flights"
"588","2007",1,94752,NA,94752,"SouthWest Flights"
"589","2007",2,85027,NA,85027,"SouthWest Flights"
"590","2007",3,97124,NA,97124,"SouthWest Flights"
"591","2007",4,95668,NA,95668,"SouthWest Flights"
"592","2007",5,98504,NA,98504,"SouthWest Flights"
"593","2007",6,96476,NA,96476,"SouthWest Flights"
"594","2007",7,100278,NA,100278,"SouthWest Flights"
"595","2007",8,101411,NA,101411,"SouthWest Flights"
"596","2007",9,96102,NA,96102,"SouthWest Flights"
"597","2007",10,99783,NA,99783,"SouthWest Flights"
"598","2007",11,97326,NA,97326,"SouthWest Flights"
"599","2007",12,98263,NA,98263,"SouthWest Flights"
"600","2008",1,100363,NA,100363,"SouthWest Flights"
"601","2008",2,92887,NA,92887,"SouthWest Flights"
"602","2008",3,101543,NA,101543,"SouthWest Flights"
"603","2008",4,100307,NA,100307,"SouthWest Flights"
"604","2008",5,102294,NA,102294,"SouthWest Flights"
"605","2008",6,100831,NA,100831,"SouthWest Flights"
"606","2008",7,103157,NA,103157,"SouthWest Flights"
"607","2008",8,101433,NA,101433,"SouthWest Flights"
"608","2008",9,95947,NA,95947,"SouthWest Flights"
"609","2008",10,101224,NA,101224,"SouthWest Flights"
"610","2008",11,95355,NA,95355,"SouthWest Flights"
"611","2008",12,95813,NA,95813,"SouthWest Flights"
"612","2009",1,94606,NA,94606,"SouthWest Flights"
"613","2009",2,86009,NA,86009,"SouthWest Flights"
"614","2009",3,98520,NA,98520,"SouthWest Flights"
"615","2009",4,96457,NA,96457,"SouthWest Flights"
"616","2009",5,97273,NA,97273,"SouthWest Flights"
"617","2009",6,95843,NA,95843,"SouthWest Flights"
"618","2009",7,98761,NA,98761,"SouthWest Flights"
"619","2009",8,95405,NA,95405,"SouthWest Flights"
"620","2009",9,89497,NA,89497,"SouthWest Flights"
"621","2009",10,92670,NA,92670,"SouthWest Flights"
"622","2009",11,89286,NA,89286,"SouthWest Flights"
"623","2009",12,90784,NA,90784,"SouthWest Flights"
"624","2010",1,88406,NA,88406,"SouthWest Flights"
"625","2010",2,78718,NA,78718,"SouthWest Flights"
"626","2010",3,94768,NA,94768,"SouthWest Flights"
"627","2010",4,93719,NA,93719,"SouthWest Flights"
"628","2010",5,96750,NA,96750,"SouthWest Flights"
"629","2010",6,96753,NA,96753,"SouthWest Flights"
"630","2010",7,98665,NA,98665,"SouthWest Flights"
"631","2010",8,97392,NA,97392,"SouthWest Flights"
"632","2010",9,91143,NA,91143,"SouthWest Flights"
"633","2010",10,94483,NA,94483,"SouthWest Flights"
"634","2010",11,91159,NA,91159,"SouthWest Flights"
"635","2010",12,92495,NA,92495,"SouthWest Flights"
"636","2011",1,92018,NA,92018,"SouthWest Flights"
"637","2011",2,82477,NA,82477,"SouthWest Flights"
"638","2011",3,99328,NA,99328,"SouthWest Flights"
"639","2011",4,96683,NA,96683,"SouthWest Flights"
"640","2011",5,99288,NA,99288,"SouthWest Flights"
"641","2011",6,100180,NA,100180,"SouthWest Flights"
"642","2011",7,102030,NA,102030,"SouthWest Flights"
"643","2011",8,99228,NA,99228,"SouthWest Flights"
"644","2011",9,92514,NA,92514,"SouthWest Flights"
"645","2011",10,96618,NA,96618,"SouthWest Flights"
"646","2011",11,90947,NA,90947,"SouthWest Flights"
"647","2011",12,93852,NA,93852,"SouthWest Flights"
"648","2012",1,90085,NA,90085,"SouthWest Flights"
"649","2012",2,86419,NA,86419,"SouthWest Flights"
"650","2012",3,98151,NA,98151,"SouthWest Flights"
"651","2012",4,96061,NA,96061,"SouthWest Flights"
"652","2012",5,98499,NA,98499,"SouthWest Flights"
"653","2012",6,98232,NA,98232,"SouthWest Flights"
"654","2012",7,101860,NA,101860,"SouthWest Flights"
"655","2012",8,97814,NA,97814,"SouthWest Flights"
"656","2012",9,89679,NA,89679,"SouthWest Flights"
"657","2012",10,94449,NA,94449,"SouthWest Flights"
"658","2012",11,89816,NA,89816,"SouthWest Flights"
"659","2012",12,91382,NA,91382,"SouthWest Flights"
"660","2013",1,88715,NA,88715,"SouthWest Flights"
"661","2013",2,81589,NA,81589,"SouthWest Flights"
"662","2013",3,98145,NA,98145,"SouthWest Flights"
"663","2013",4,96712,NA,96712,"SouthWest Flights"
"664","2013",5,98584,NA,98584,"SouthWest Flights"
"665","2013",6,96921,NA,96921,"SouthWest Flights"
"666","2013",7,99794,NA,99794,"SouthWest Flights"
"667","2013",8,96283,NA,96283,"SouthWest Flights"
"668","2013",9,89563,NA,89563,"SouthWest Flights"
"669","2013",10,94220,NA,94220,"SouthWest Flights"
"670","2013",11,89241,NA,89241,"SouthWest Flights"
"671","2013",12,94221,NA,94221,"SouthWest Flights"
"672","2014",1,87334,NA,87334,"SouthWest Flights"
"673","2014",2,82012,NA,82012,"SouthWest Flights"
"674","2014",3,100338,NA,100338,"SouthWest Flights"
"675","2014",4,98716,NA,98716,"SouthWest Flights"
"676","2014",5,100197,NA,100197,"SouthWest Flights"
"677","2014",6,101531,NA,101531,"SouthWest Flights"
"678","2014",7,104655,442,105097,"SouthWest Flights"
"679","2014",8,99206,530,99736,"SouthWest Flights"
"680","2014",9,93765,510,94275,"SouthWest Flights"
"681","2014",10,98651,585,99236,"SouthWest Flights"
"682","2014",11,95105,1384,96489,"SouthWest Flights"
"683","2014",12,100173,1448,101621,"SouthWest Flights"
"684","2015",1,98417,1354,99771,"SouthWest Flights"
"685","2015",2,86840,1198,88038,"SouthWest Flights"
"686","2015",3,107279,1484,108763,"SouthWest Flights"
"687","2015",4,106012,1566,107578,"SouthWest Flights"
"688","2015",5,107039,1654,108693,"SouthWest Flights"
"689","2015",6,108308,1730,110038,"SouthWest Flights"
"690","2015",7,113184,1832,115016,"SouthWest Flights"
"691","2015",8,107499,1318,108817,"SouthWest Flights"
"692","2015",9,100390,1076,101466,"SouthWest Flights"
"693","2015",10,104306,1383,105689,"SouthWest Flights"
"694","2015",11,103214,2065,105279,"SouthWest Flights"
"695","2015",12,106071,2136,108207,"SouthWest Flights"
"696","2016",1,101623,2037,103660,"SouthWest Flights"
"697","2016",2,95924,1900,97824,"SouthWest Flights"
"698","2016",3,110884,2167,113051,"SouthWest Flights"
"699","2016",4,107047,2172,109219,"SouthWest Flights"
"700","2016",5,109593,2208,111801,"SouthWest Flights"
"701","2016",6,111163,2266,113429,"SouthWest Flights"
"702","2016",7,112228,2389,114617,"SouthWest Flights"
"703","2016",8,110391,1874,112265,"SouthWest Flights"
"704","2016",9,103890,1645,105535,"SouthWest Flights"
"705","2016",10,107429,1686,109115,"SouthWest Flights"
"706","2016",11,106840,2018,108858,"SouthWest Flights"
"707","2016",12,109111,2654,111765,"SouthWest Flights"
"708","2017",1,105683,2754,108437,"SouthWest Flights"
"709","2017",2,94593,2563,97156,"SouthWest Flights"
"710","2017",3,113188,3007,116195,"SouthWest Flights"
"711","2017",4,111547,2975,114522,"SouthWest Flights"
"712","2017",5,112875,2827,115702,"SouthWest Flights"
"713","2017",6,114364,3233,117597,"SouthWest Flights"
"714","2017",7,117416,3452,120868,"SouthWest Flights"
"715","2017",8,113076,2761,115837,"SouthWest Flights"
"716","2017",9,102352,2027,104379,"SouthWest Flights"
"717","2017",10,109710,2337,112047,"SouthWest Flights"
"718","2017",11,108647,3043,111690,"SouthWest Flights"
"719","2017",12,110122,3329,113451,"SouthWest Flights"
"720","2018",1,107342,3167,110509,"SouthWest Flights"
"721","2018",2,95101,2858,97959,"SouthWest Flights"
"722","2018",3,114249,3498,117747,"SouthWest Flights"
"723","2018",4,113030,3332,116362,"SouthWest Flights"
"724","2018",5,115644,3380,119024,"SouthWest Flights"
"725","2018",6,114987,3551,118538,"SouthWest Flights"
"726","2018",7,118350,3680,122030,"SouthWest Flights"
"727","2018",8,113914,2958,116872,"SouthWest Flights"
"728","2018",9,106109,2543,108652,"SouthWest Flights"
"729","2018",10,114189,2627,116816,"SouthWest Flights"
"730","2018",11,111427,3298,114725,"SouthWest Flights"
"731","2018",12,112255,3533,115788,"SouthWest Flights"
"732","2019",1,107469,3233,110702,"SouthWest Flights"
"733","2019",2,95150,2811,97961,"SouthWest Flights"
"734","2019",3,114234,3491,117725,"SouthWest Flights"
"735","2019",4,110976,3089,114065,"SouthWest Flights"
"736","2019",5,114073,3119,117192,"SouthWest Flights"
"737","2019",6,113303,3124,116427,"SouthWest Flights"
"738","2019",7,118067,3158,121225,"SouthWest Flights"
"739","2019",8,115215,2351,117566,"SouthWest Flights"
"740","2019",9,107616,1828,109444,"SouthWest Flights"
"741","2019",10,115220,2217,117437,"SouthWest Flights"
"742","2019",11,108260,3069,111329,"SouthWest Flights"
"743","2019",12,113415,3234,116649,"SouthWest Flights"
"744","2020",1,107976,2522,110498,"SouthWest Flights"
"745","2020",2,100564,2319,102883,"SouthWest Flights"
"746","2020",3,96883,2127,99010,"SouthWest Flights"
"747","2020",4,45679,0,45679,"SouthWest Flights"
"748","2020",5,85392,NA,85392,"SouthWest Flights"
"749","2020",6,64713,NA,64713,"SouthWest Flights"
"750","2020",7,82279,663,82942,"SouthWest Flights"
"751","2020",8,83915,604,84519,"SouthWest Flights"
"752","2020",9,63044,600,63644,"SouthWest Flights"
"753","2020",10,63933,822,64755,"SouthWest Flights"
"754","2020",11,69909,1295,71204,"SouthWest Flights"
"755","2020",12,63752,1243,64995,"SouthWest Flights"
"756","2021",1,60668,1187,61855,"SouthWest Flights"
"757","2021",2,48965,1015,49980,"SouthWest Flights"
"758","2021",3,78908,1658,80566,"SouthWest Flights"
"759","2021",4,79887,1869,81756,"SouthWest Flights"
"760","2021",5,87256,2010,89266,"SouthWest Flights"
"761","2021",6,95661,2135,97796,"SouthWest Flights"
"762","2021",7,102636,2347,104983,"SouthWest Flights"
"763","2021",8,101349,2300,103649,"SouthWest Flights"
"764","2021",9,95447,1676,97123,"SouthWest Flights"
"765","2021",10,99479,1896,101375,"SouthWest Flights"
"766","2021",11,97016,2236,99252,"SouthWest Flights"
"767","2021",12,96436,2417,98853,"SouthWest Flights"
"768","2022",1,91104,2430,93534,"SouthWest Flights"
"769","2022",2,87312,2199,89511,"SouthWest Flights"
"770","2022",3,101908,2797,104705,"SouthWest Flights"
"771","2022",4,101231,2672,103903,"SouthWest Flights"
"772","2022",5,107479,2638,110117,"SouthWest Flights"
"773","2022",6,109962,2866,112828,"SouthWest Flights"
"774","2022",7,116380,3088,119468,"SouthWest Flights"
"775","2022",8,116100,3016,119116,"SouthWest Flights"
"776","2022",9,110677,1953,112630,"SouthWest Flights"
"777","2022",10,115495,2012,117507,"SouthWest Flights"
"778","2022",11,110376,2432,112808,"SouthWest Flights"
"779","2022",12,99439,2646,102085,"SouthWest Flights"
"780","2023",1,109522,2568,112090,"SouthWest Flights"
"781","2023",2,99490,2333,101823,"SouthWest Flights"
"782","2023",3,117146,3060,120206,"SouthWest Flights"
"783","2023",4,115021,2922,117943,"SouthWest Flights"
"784","2023",5,122195,2766,124961,"SouthWest Flights"
"785","2023",6,119055,3126,122181,"SouthWest Flights"
"786","2023",7,125792,3380,129172,"SouthWest Flights"
"787","2023",8,123980,2603,126583,"SouthWest Flights"
"788","2023",9,117481,1688,119169,"SouthWest Flights"
"789","2023",10,128449,1986,130435,"SouthWest Flights"
"790","2023",11,122314,2552,124866,"SouthWest Flights"
"791","2023",12,127176,2814,129990,"SouthWest Flights"
"792","2024",1,112070,2663,114733,"SouthWest Flights"
"793","2024",2,104912,2526,107438,"SouthWest Flights"
"794","2024",3,124393,3410,127803,"SouthWest Flights"
"795","2024",4,120313,2950,123263,"SouthWest Flights"
"796","2024",5,122180,2888,125068,"SouthWest Flights"
"797","2024",6,123812,3601,127413,"SouthWest Flights"
"798","2024",7,127376,3604,130980,"SouthWest Flights"
"799","2024",8,117665,2053,119718,"SouthWest Flights"
"800","2024",9,112202,1706,113908,"SouthWest Flights"
"801","2024",10,117857,2058,119915,"SouthWest Flights"
"802","2024",11,112339,2534,114873,"SouthWest Flights"
"803","2024",12,116039,2699,118738,"SouthWest Flights"
"804","2025",1,102477,2318,104795,"SouthWest Flights"
"805",NA,NA,NA,NA,NA,"SouthWest Flights"
"806",NA,NA,NA,NA,NA,"SouthWest Flights"
"807",NA,NA,NA,NA,NA,"SouthWest Flights"
"808",NA,NA,NA,NA,NA,"SouthWest Flights"
"809","2002",10,4276,NA,4276,"JetBlue Flights"
"810","2002",11,4287,NA,4287,"JetBlue Flights"
"811","2002",12,4776,NA,4776,"JetBlue Flights"
"812","2003",1,5006,NA,5006,"JetBlue Flights"
"813","2003",2,4720,NA,4720,"JetBlue Flights"
"814","2003",3,5685,NA,5685,"JetBlue Flights"
"815","2003",4,5601,NA,5601,"JetBlue Flights"
"816","2003",5,5260,NA,5260,"JetBlue Flights"
"817","2003",6,5272,NA,5272,"JetBlue Flights"
"818","2003",7,5841,NA,5841,"JetBlue Flights"
"819","2003",8,5837,NA,5837,"JetBlue Flights"
"820","2003",9,5497,NA,5497,"JetBlue Flights"
"821","2003",10,5846,NA,5846,"JetBlue Flights"
"822","2003",11,5894,NA,5894,"JetBlue Flights"
"823","2003",12,6461,NA,6461,"JetBlue Flights"
"824","2004",1,6760,NA,6760,"JetBlue Flights"
"825","2004",2,6719,NA,6719,"JetBlue Flights"
"826","2004",3,7366,NA,7366,"JetBlue Flights"
"827","2004",4,7426,NA,7426,"JetBlue Flights"
"828","2004",5,7334,NA,7334,"JetBlue Flights"
"829","2004",6,7275,110,7385,"JetBlue Flights"
"830","2004",7,7725,186,7911,"JetBlue Flights"
"831","2004",8,7738,186,7924,"JetBlue Flights"
"832","2004",9,6908,150,7058,"JetBlue Flights"
"833","2004",10,7856,124,7980,"JetBlue Flights"
"834","2004",11,7871,180,8051,"JetBlue Flights"
"835","2004",12,8433,185,8618,"JetBlue Flights"
"836","2005",1,8227,180,8407,"JetBlue Flights"
"837","2005",2,7827,168,7995,"JetBlue Flights"
"838","2005",3,9110,125,9235,"JetBlue Flights"
"839","2005",4,9202,140,9342,"JetBlue Flights"
"840","2005",5,8901,127,9028,"JetBlue Flights"
"841","2005",6,8892,120,9012,"JetBlue Flights"
"842","2005",7,9507,184,9691,"JetBlue Flights"
"843","2005",8,9522,186,9708,"JetBlue Flights"
"844","2005",9,8575,130,8705,"JetBlue Flights"
"845","2005",10,9134,123,9257,"JetBlue Flights"
"846","2005",11,10155,150,10305,"JetBlue Flights"
"847","2005",12,11127,174,11301,"JetBlue Flights"
"848","2006",1,11024,172,11196,"JetBlue Flights"
"849","2006",2,10372,210,10582,"JetBlue Flights"
"850","2006",3,12387,248,12635,"JetBlue Flights"
"851","2006",4,12535,256,12791,"JetBlue Flights"
"852","2006",5,12014,331,12345,"JetBlue Flights"
"853","2006",6,12188,364,12552,"JetBlue Flights"
"854","2006",7,13819,409,14228,"JetBlue Flights"
"855","2006",8,14321,422,14743,"JetBlue Flights"
"856","2006",9,13021,307,13328,"JetBlue Flights"
"857","2006",10,13928,316,14244,"JetBlue Flights"
"858","2006",11,14302,325,14627,"JetBlue Flights"
"859","2006",12,15394,455,15849,"JetBlue Flights"
"860","2007",1,15337,436,15773,"JetBlue Flights"
"861","2007",2,13209,387,13596,"JetBlue Flights"
"862","2007",3,16234,521,16755,"JetBlue Flights"
"863","2007",4,16257,519,16776,"JetBlue Flights"
"864","2007",5,15818,562,16380,"JetBlue Flights"
"865","2007",6,15245,726,15971,"JetBlue Flights"
"866","2007",7,16284,856,17140,"JetBlue Flights"
"867","2007",8,16550,926,17476,"JetBlue Flights"
"868","2007",9,15079,632,15711,"JetBlue Flights"
"869","2007",10,15428,576,16004,"JetBlue Flights"
"870","2007",11,16065,691,16756,"JetBlue Flights"
"871","2007",12,16658,862,17520,"JetBlue Flights"
"872","2008",1,16250,843,17093,"JetBlue Flights"
"873","2008",2,15633,805,16438,"JetBlue Flights"
"874","2008",3,17715,1019,18734,"JetBlue Flights"
"875","2008",4,17016,1006,18022,"JetBlue Flights"
"876","2008",5,16144,926,17070,"JetBlue Flights"
"877","2008",6,16167,977,17144,"JetBlue Flights"
"878","2008",7,16910,1181,18091,"JetBlue Flights"
"879","2008",8,16955,1254,18209,"JetBlue Flights"
"880","2008",9,13932,902,14834,"JetBlue Flights"
"881","2008",10,14500,905,15405,"JetBlue Flights"
"882","2008",11,15554,1123,16677,"JetBlue Flights"
"883","2008",12,16261,1420,17681,"JetBlue Flights"
"884","2009",1,16001,1451,17452,"JetBlue Flights"
"885","2009",2,14997,1700,16697,"JetBlue Flights"
"886","2009",3,16884,1979,18863,"JetBlue Flights"
"887","2009",4,16370,1966,18336,"JetBlue Flights"
"888","2009",5,16168,1958,18126,"JetBlue Flights"
"889","2009",6,16351,2072,18423,"JetBlue Flights"
"890","2009",7,17160,2383,19543,"JetBlue Flights"
"891","2009",8,17147,2409,19556,"JetBlue Flights"
"892","2009",9,14483,1838,16321,"JetBlue Flights"
"893","2009",10,14695,1750,16445,"JetBlue Flights"
"894","2009",11,15357,1967,17324,"JetBlue Flights"
"895","2009",12,16246,2192,18438,"JetBlue Flights"
"896","2010",1,16027,2183,18210,"JetBlue Flights"
"897","2010",2,14484,2052,16536,"JetBlue Flights"
"898","2010",3,17268,2353,19621,"JetBlue Flights"
"899","2010",4,16786,2299,19085,"JetBlue Flights"
"900","2010",5,16002,2409,18411,"JetBlue Flights"
"901","2010",6,16320,2506,18826,"JetBlue Flights"
"902","2010",7,17740,2942,20682,"JetBlue Flights"
"903","2010",8,17651,2920,20571,"JetBlue Flights"
"904","2010",9,15716,2089,17805,"JetBlue Flights"
"905","2010",10,16483,2027,18510,"JetBlue Flights"
"906","2010",11,16718,1962,18680,"JetBlue Flights"
"907","2010",12,16654,2278,18932,"JetBlue Flights"
"908","2011",1,16244,2260,18504,"JetBlue Flights"
"909","2011",2,15259,2106,17365,"JetBlue Flights"
"910","2011",3,18466,2522,20988,"JetBlue Flights"
"911","2011",4,18106,2589,20695,"JetBlue Flights"
"912","2011",5,17901,2390,20291,"JetBlue Flights"
"913","2011",6,18205,2601,20806,"JetBlue Flights"
"914","2011",7,19501,3180,22681,"JetBlue Flights"
"915","2011",8,18276,2903,21179,"JetBlue Flights"
"916","2011",9,16940,2456,19396,"JetBlue Flights"
"917","2011",10,17411,2384,19795,"JetBlue Flights"
"918","2011",11,17636,2550,20186,"JetBlue Flights"
"919","2011",12,18908,3225,22133,"JetBlue Flights"
"920","2012",1,17842,2842,20684,"JetBlue Flights"
"921","2012",2,17349,2720,20069,"JetBlue Flights"
"922","2012",3,19707,3151,22858,"JetBlue Flights"
"923","2012",4,19135,3148,22283,"JetBlue Flights"
"924","2012",5,18713,2941,21654,"JetBlue Flights"
"925","2012",6,19079,3147,22226,"JetBlue Flights"
"926","2012",7,20719,3787,24506,"JetBlue Flights"
"927","2012",8,20693,3753,24446,"JetBlue Flights"
"928","2012",9,18152,2927,21079,"JetBlue Flights"
"929","2012",10,17302,2676,19978,"JetBlue Flights"
"930","2012",11,18630,3104,21734,"JetBlue Flights"
"931","2012",12,19862,3592,23454,"JetBlue Flights"
"932","2013",1,19292,3287,22579,"JetBlue Flights"
"933","2013",2,17126,2993,20119,"JetBlue Flights"
"934","2013",3,20748,3429,24177,"JetBlue Flights"
"935","2013",4,19937,3417,23354,"JetBlue Flights"
"936","2013",5,20232,3219,23451,"JetBlue Flights"
"937","2013",6,20587,3502,24089,"JetBlue Flights"
"938","2013",7,22027,4312,26339,"JetBlue Flights"
"939","2013",8,21999,4306,26305,"JetBlue Flights"
"940","2013",9,18590,3104,21694,"JetBlue Flights"
"941","2013",10,19380,3102,22482,"JetBlue Flights"
"942","2013",11,19570,3256,22826,"JetBlue Flights"
"943","2013",12,20988,4224,25212,"JetBlue Flights"
"944","2014",1,18190,3870,22060,"JetBlue Flights"
"945","2014",2,17576,3600,21176,"JetBlue Flights"
"946","2014",3,21092,4020,25112,"JetBlue Flights"
"947","2014",4,20713,4016,24729,"JetBlue Flights"
"948","2014",5,20791,4218,25009,"JetBlue Flights"
"949","2014",6,20877,4437,25314,"JetBlue Flights"
"950","2014",7,21992,5162,27154,"JetBlue Flights"
"951","2014",8,22241,5216,27457,"JetBlue Flights"
"952","2014",9,19071,3667,22738,"JetBlue Flights"
"953","2014",10,20080,3775,23855,"JetBlue Flights"
"954","2014",11,19935,4023,23958,"JetBlue Flights"
"955","2014",12,21952,4878,26830,"JetBlue Flights"
"956","2015",1,20572,4572,25144,"JetBlue Flights"
"957","2015",2,18539,3839,22378,"JetBlue Flights"
"958","2015",3,22253,4247,26500,"JetBlue Flights"
"959","2015",4,21954,4296,26250,"JetBlue Flights"
"960","2015",5,22434,4200,26634,"JetBlue Flights"
"961","2015",6,22418,4466,26884,"JetBlue Flights"
"962","2015",7,23870,5311,29181,"JetBlue Flights"
"963","2015",8,23642,5326,28968,"JetBlue Flights"
"964","2015",9,21086,3919,25005,"JetBlue Flights"
"965","2015",10,21826,4082,25908,"JetBlue Flights"
"966","2015",11,21622,4174,25796,"JetBlue Flights"
"967","2015",12,23347,5222,28569,"JetBlue Flights"
"968","2016",1,22175,4900,27075,"JetBlue Flights"
"969","2016",2,21301,4441,25742,"JetBlue Flights"
"970","2016",3,23775,4809,28584,"JetBlue Flights"
"971","2016",4,23066,4730,27796,"JetBlue Flights"
"972","2016",5,24186,4698,28884,"JetBlue Flights"
"973","2016",6,23703,5035,28738,"JetBlue Flights"
"974","2016",7,24506,5636,30142,"JetBlue Flights"
"975","2016",8,24488,5745,30233,"JetBlue Flights"
"976","2016",9,22322,4284,26606,"JetBlue Flights"
"977","2016",10,22753,4242,26995,"JetBlue Flights"
"978","2016",11,22967,4419,27386,"JetBlue Flights"
"979","2016",12,24181,5588,29769,"JetBlue Flights"
"980","2017",1,24189,5239,29428,"JetBlue Flights"
"981","2017",2,21632,4631,26263,"JetBlue Flights"
"982","2017",3,25012,5226,30238,"JetBlue Flights"
"983","2017",4,24874,5173,30047,"JetBlue Flights"
"984","2017",5,24944,5103,30047,"JetBlue Flights"
"985","2017",6,24809,5468,30277,"JetBlue Flights"
"986","2017",7,25934,6251,32185,"JetBlue Flights"
"987","2017",8,25732,6137,31869,"JetBlue Flights"
"988","2017",9,21987,4191,26178,"JetBlue Flights"
"989","2017",10,24219,4578,28797,"JetBlue Flights"
"990","2017",11,23661,4663,28324,"JetBlue Flights"
"991","2017",12,25002,5709,30711,"JetBlue Flights"
"992","2018",1,23518,5129,28647,"JetBlue Flights"
"993","2018",2,22569,4764,27333,"JetBlue Flights"
"994","2018",3,24941,5337,30278,"JetBlue Flights"
"995","2018",4,25603,5368,30971,"JetBlue Flights"
"996","2018",5,26279,5254,31533,"JetBlue Flights"
"997","2018",6,25686,5723,31409,"JetBlue Flights"
"998","2018",7,26148,6641,32789,"JetBlue Flights"
"999","2018",8,26063,6608,32671,"JetBlue Flights"
"1000","2018",9,24241,5648,29889,"JetBlue Flights"
"1001","2018",10,24847,5419,30266,"JetBlue Flights"
"1002","2018",11,24460,5471,29931,"JetBlue Flights"
"1003","2018",12,25359,6358,31717,"JetBlue Flights"
"1004","2019",1,23554,6098,29652,"JetBlue Flights"
"1005","2019",2,22135,5569,27704,"JetBlue Flights"
"1006","2019",3,25580,6482,32062,"JetBlue Flights"
"1007","2019",4,25070,6162,31232,"JetBlue Flights"
"1008","2019",5,24982,6180,31162,"JetBlue Flights"
"1009","2019",6,24333,6598,30931,"JetBlue Flights"
"1010","2019",7,25231,7287,32518,"JetBlue Flights"
"1011","2019",8,25374,7360,32734,"JetBlue Flights"
"1012","2019",9,23698,5472,29170,"JetBlue Flights"
"1013","2019",10,24857,5456,30313,"JetBlue Flights"
"1014","2019",11,24742,5582,30324,"JetBlue Flights"
"1015","2019",12,25107,6319,31426,"JetBlue Flights"
"1016","2020",1,24758,5359,30117,"JetBlue Flights"
"1017","2020",2,23553,4836,28389,"JetBlue Flights"
"1018","2020",3,21265,3665,24930,"JetBlue Flights"
"1019","2020",4,4423,106,4529,"JetBlue Flights"
"1020","2020",5,2607,158,2765,"JetBlue Flights"
"1021","2020",6,5344,279,5623,"JetBlue Flights"
"1022","2020",7,10254,2978,13232,"JetBlue Flights"
"1023","2020",8,7680,2734,10414,"JetBlue Flights"
"1024","2020",9,6351,2232,8583,"JetBlue Flights"
"1025","2020",10,8812,2589,11401,"JetBlue Flights"
"1026","2020",11,10676,2921,13597,"JetBlue Flights"
"1027","2020",12,10864,4511,15375,"JetBlue Flights"
"1028","2021",1,8522,3958,12480,"JetBlue Flights"
"1029","2021",2,9627,3487,13114,"JetBlue Flights"
"1030","2021",3,13683,4432,18115,"JetBlue Flights"
"1031","2021",4,15185,4084,19269,"JetBlue Flights"
"1032","2021",5,17594,5599,23193,"JetBlue Flights"
"1033","2021",6,18410,6616,25026,"JetBlue Flights"
"1034","2021",7,19847,6593,26440,"JetBlue Flights"
"1035","2021",8,19994,6691,26685,"JetBlue Flights"
"1036","2021",9,18197,5980,24177,"JetBlue Flights"
"1037","2021",10,19118,5658,24776,"JetBlue Flights"
"1038","2021",11,19639,5143,24782,"JetBlue Flights"
"1039","2021",12,20380,6454,26834,"JetBlue Flights"
"1040","2022",1,19283,5846,25129,"JetBlue Flights"
"1041","2022",2,19590,5377,24967,"JetBlue Flights"
"1042","2022",3,22390,6112,28502,"JetBlue Flights"
"1043","2022",4,22043,6223,28266,"JetBlue Flights"
"1044","2022",5,23188,5536,28724,"JetBlue Flights"
"1045","2022",6,20696,6048,26744,"JetBlue Flights"
"1046","2022",7,22589,6455,29044,"JetBlue Flights"
"1047","2022",8,22647,6724,29371,"JetBlue Flights"
"1048","2022",9,21805,4885,26690,"JetBlue Flights"
"1049","2022",10,23083,4864,27947,"JetBlue Flights"
"1050","2022",11,23110,5143,28253,"JetBlue Flights"
"1051","2022",12,23491,6524,30015,"JetBlue Flights"
"1052","2023",1,23171,5921,29092,"JetBlue Flights"
"1053","2023",2,21914,5124,27038,"JetBlue Flights"
"1054","2023",3,25515,6134,31649,"JetBlue Flights"
"1055","2023",4,23850,6182,30032,"JetBlue Flights"
"1056","2023",5,24551,6070,30621,"JetBlue Flights"
"1057","2023",6,22231,6612,28843,"JetBlue Flights"
"1058","2023",7,21438,7550,28988,"JetBlue Flights"
"1059","2023",8,22379,7958,30337,"JetBlue Flights"
"1060","2023",9,20825,6071,26896,"JetBlue Flights"
"1061","2023",10,22099,5897,27996,"JetBlue Flights"
"1062","2023",11,21294,6515,27809,"JetBlue Flights"
"1063","2023",12,21358,7710,29068,"JetBlue Flights"
"1064","2024",1,19338,6866,26204,"JetBlue Flights"
"1065","2024",2,19040,6260,25300,"JetBlue Flights"
"1066","2024",3,21426,6986,28412,"JetBlue Flights"
"1067","2024",4,19903,7010,26913,"JetBlue Flights"
"1068","2024",5,21221,6606,27827,"JetBlue Flights"
"1069","2024",6,19553,7423,26976,"JetBlue Flights"
"1070","2024",7,20155,8301,28456,"JetBlue Flights"
"1071","2024",8,19736,8443,28179,"JetBlue Flights"
"1072","2024",9,18334,5755,24089,"JetBlue Flights"
"1073","2024",10,19285,5876,25161,"JetBlue Flights"
"1074","2024",11,19148,6539,25687,"JetBlue Flights"
"1075","2024",12,20596,7533,28129,"JetBlue Flights"
"1076","2025",1,17628,6313,23941,"JetBlue Flights"
"1077","2002",10,4510,NA,4510,"Frontier Flights"
"1078","2002",11,4318,NA,4318,"Frontier Flights"
"1079","2002",12,4683,27,4710,"Frontier Flights"
"1080","2003",1,4712,81,4793,"Frontier Flights"
"1081","2003",2,4303,72,4375,"Frontier Flights"
"1082","2003",3,4574,74,4648,"Frontier Flights"
"1083","2003",4,4831,71,4902,"Frontier Flights"
"1084","2003",5,4789,72,4861,"Frontier Flights"
"1085","2003",6,4786,68,4854,"Frontier Flights"
"1086","2003",7,5055,50,5105,"Frontier Flights"
"1087","2003",8,5021,53,5074,"Frontier Flights"
"1088","2003",9,4864,34,4898,"Frontier Flights"
"1089","2003",10,5119,34,5153,"Frontier Flights"
"1090","2003",11,4974,96,5070,"Frontier Flights"
"1091","2003",12,5386,156,5542,"Frontier Flights"
"1092","2004",1,5308,155,5463,"Frontier Flights"
"1093","2004",2,5001,158,5159,"Frontier Flights"
"1094","2004",3,5590,173,5763,"Frontier Flights"
"1095","2004",4,5403,162,5565,"Frontier Flights"
"1096","2004",5,5705,172,5877,"Frontier Flights"
"1097","2004",6,6005,162,6167,"Frontier Flights"
"1098","2004",7,6593,180,6773,"Frontier Flights"
"1099","2004",8,6326,119,6445,"Frontier Flights"
"1100","2004",9,5622,74,5696,"Frontier Flights"
"1101","2004",10,5804,156,5960,"Frontier Flights"
"1102","2004",11,5465,291,5756,"Frontier Flights"
"1103","2004",12,5953,389,6342,"Frontier Flights"
"1104","2005",1,5775,390,6165,"Frontier Flights"
"1105","2005",2,5134,340,5474,"Frontier Flights"
"1106","2005",3,6152,403,6555,"Frontier Flights"
"1107","2005",4,5655,346,6001,"Frontier Flights"
"1108","2005",5,6287,314,6601,"Frontier Flights"
"1109","2005",6,6442,288,6730,"Frontier Flights"
"1110","2005",7,7119,225,7344,"Frontier Flights"
"1111","2005",8,6931,144,7075,"Frontier Flights"
"1112","2005",9,6474,200,6674,"Frontier Flights"
"1113","2005",10,6719,141,6860,"Frontier Flights"
"1114","2005",11,6406,169,6575,"Frontier Flights"
"1115","2005",12,6814,385,7199,"Frontier Flights"
"1116","2006",1,6902,409,7311,"Frontier Flights"
"1117","2006",2,6253,375,6628,"Frontier Flights"
"1118","2006",3,7020,524,7544,"Frontier Flights"
"1119","2006",4,6889,469,7358,"Frontier Flights"
"1120","2006",5,7709,380,8089,"Frontier Flights"
"1121","2006",6,7680,375,8055,"Frontier Flights"
"1122","2006",7,8280,320,8600,"Frontier Flights"
"1123","2006",8,8380,191,8571,"Frontier Flights"
"1124","2006",9,7920,144,8064,"Frontier Flights"
"1125","2006",10,8049,172,8221,"Frontier Flights"
"1126","2006",11,7460,294,7754,"Frontier Flights"
"1127","2006",12,6960,586,7546,"Frontier Flights"
"1128","2007",1,7758,646,8404,"Frontier Flights"
"1129","2007",2,7082,588,7670,"Frontier Flights"
"1130","2007",3,8067,837,8904,"Frontier Flights"
"1131","2007",4,7864,687,8551,"Frontier Flights"
"1132","2007",5,8494,639,9133,"Frontier Flights"
"1133","2007",6,8376,686,9062,"Frontier Flights"
"1134","2007",7,9034,527,9561,"Frontier Flights"
"1135","2007",8,8812,446,9258,"Frontier Flights"
"1136","2007",9,7966,369,8335,"Frontier Flights"
"1137","2007",10,8300,377,8677,"Frontier Flights"
"1138","2007",11,7867,509,8376,"Frontier Flights"
"1139","2007",12,7941,809,8750,"Frontier Flights"
"1140","2008",1,7700,677,8377,"Frontier Flights"
"1141","2008",2,7088,589,7677,"Frontier Flights"
"1142","2008",3,7950,765,8715,"Frontier Flights"
"1143","2008",4,7922,513,8435,"Frontier Flights"
"1144","2008",5,8591,412,9003,"Frontier Flights"
"1145","2008",6,8612,361,8973,"Frontier Flights"
"1146","2008",7,9355,203,9558,"Frontier Flights"
"1147","2008",8,9026,176,9202,"Frontier Flights"
"1148","2008",9,7512,104,7616,"Frontier Flights"
"1149","2008",10,7583,142,7725,"Frontier Flights"
"1150","2008",11,7118,274,7392,"Frontier Flights"
"1151","2008",12,7364,402,7766,"Frontier Flights"
"1152","2009",1,7238,434,7672,"Frontier Flights"
"1153","2009",2,6511,382,6893,"Frontier Flights"
"1154","2009",3,7191,412,7603,"Frontier Flights"
"1155","2009",4,7045,372,7417,"Frontier Flights"
"1156","2009",5,7706,200,7906,"Frontier Flights"
"1157","2009",6,7671,136,7807,"Frontier Flights"
"1158","2009",7,7878,140,8018,"Frontier Flights"
"1159","2009",8,7845,138,7983,"Frontier Flights"
"1160","2009",9,7227,76,7303,"Frontier Flights"
"1161","2009",10,7146,137,7283,"Frontier Flights"
"1162","2009",11,6152,246,6398,"Frontier Flights"
"1163","2009",12,5940,344,6284,"Frontier Flights"
"1164","2010",1,5887,432,6319,"Frontier Flights"
"1165","2010",2,5626,382,6008,"Frontier Flights"
"1166","2010",3,6782,408,7190,"Frontier Flights"
"1167","2010",4,6731,344,7075,"Frontier Flights"
"1168","2010",5,7101,154,7255,"Frontier Flights"
"1169","2010",6,7211,140,7351,"Frontier Flights"
"1170","2010",7,7478,165,7643,"Frontier Flights"
"1171","2010",8,7366,135,7501,"Frontier Flights"
"1172","2010",9,6848,84,6932,"Frontier Flights"
"1173","2010",10,6696,138,6834,"Frontier Flights"
"1174","2010",11,6318,242,6560,"Frontier Flights"
"1175","2010",12,6410,356,6766,"Frontier Flights"
"1176","2011",1,6217,474,6691,"Frontier Flights"
"1177","2011",2,5758,414,6172,"Frontier Flights"
"1178","2011",3,6777,481,7258,"Frontier Flights"
"1179","2011",4,6401,432,6833,"Frontier Flights"
"1180","2011",5,7249,160,7409,"Frontier Flights"
"1181","2011",6,7604,148,7752,"Frontier Flights"
"1182","2011",7,7857,167,8024,"Frontier Flights"
"1183","2011",8,8207,128,8335,"Frontier Flights"
"1184","2011",9,7510,76,7586,"Frontier Flights"
"1185","2011",10,7375,120,7495,"Frontier Flights"
"1186","2011",11,6963,228,7191,"Frontier Flights"
"1187","2011",12,7103,333,7436,"Frontier Flights"
"1188","2012",1,6443,324,6767,"Frontier Flights"
"1189","2012",2,5948,475,6423,"Frontier Flights"
"1190","2012",3,6762,564,7326,"Frontier Flights"
"1191","2012",4,6263,331,6594,"Frontier Flights"
"1192","2012",5,6788,132,6920,"Frontier Flights"
"1193","2012",6,6961,149,7110,"Frontier Flights"
"1194","2012",7,7256,147,7403,"Frontier Flights"
"1195","2012",8,7085,106,7191,"Frontier Flights"
"1196","2012",9,6306,80,6386,"Frontier Flights"
"1197","2012",10,6559,95,6654,"Frontier Flights"
"1198","2012",11,6194,269,6463,"Frontier Flights"
"1199","2012",12,6304,315,6619,"Frontier Flights"
"1200","2013",1,5775,319,6094,"Frontier Flights"
"1201","2013",2,5181,309,5490,"Frontier Flights"
"1202","2013",3,5838,359,6197,"Frontier Flights"
"1203","2013",4,5827,259,6086,"Frontier Flights"
"1204","2013",5,6562,137,6699,"Frontier Flights"
"1205","2013",6,6553,164,6717,"Frontier Flights"
"1206","2013",7,6796,181,6977,"Frontier Flights"
"1207","2013",8,6860,128,6988,"Frontier Flights"
"1208","2013",9,6467,78,6545,"Frontier Flights"
"1209","2013",10,6466,119,6585,"Frontier Flights"
"1210","2013",11,6252,203,6455,"Frontier Flights"
"1211","2013",12,6456,294,6750,"Frontier Flights"
"1212","2014",1,5650,343,5993,"Frontier Flights"
"1213","2014",2,5171,335,5506,"Frontier Flights"
"1214","2014",3,6027,394,6421,"Frontier Flights"
"1215","2014",4,5965,332,6297,"Frontier Flights"
"1216","2014",5,7268,148,7416,"Frontier Flights"
"1217","2014",6,7551,160,7711,"Frontier Flights"
"1218","2014",7,8039,162,8201,"Frontier Flights"
"1219","2014",8,8009,119,8128,"Frontier Flights"
"1220","2014",9,7911,77,7988,"Frontier Flights"
"1221","2014",10,8137,88,8225,"Frontier Flights"
"1222","2014",11,7664,179,7843,"Frontier Flights"
"1223","2014",12,7797,255,8052,"Frontier Flights"
"1224","2015",1,6840,368,7208,"Frontier Flights"
"1225","2015",2,5803,356,6159,"Frontier Flights"
"1226","2015",3,6944,335,7279,"Frontier Flights"
"1227","2015",4,7161,254,7415,"Frontier Flights"
"1228","2015",5,8126,90,8216,"Frontier Flights"
"1229","2015",6,7911,95,8006,"Frontier Flights"
"1230","2015",7,8095,88,8183,"Frontier Flights"
"1231","2015",8,8154,100,8254,"Frontier Flights"
"1232","2015",9,7875,104,7979,"Frontier Flights"
"1233","2015",10,8264,171,8435,"Frontier Flights"
"1234","2015",11,7763,390,8153,"Frontier Flights"
"1235","2015",12,8111,194,8305,"Frontier Flights"
"1236","2016",1,7099,501,7600,"Frontier Flights"
"1237","2016",2,6549,464,7013,"Frontier Flights"
"1238","2016",3,6887,489,7376,"Frontier Flights"
"1239","2016",4,7092,358,7450,"Frontier Flights"
"1240","2016",5,7904,276,8180,"Frontier Flights"
"1241","2016",6,8101,266,8367,"Frontier Flights"
"1242","2016",7,8997,274,9271,"Frontier Flights"
"1243","2016",8,8900,228,9128,"Frontier Flights"
"1244","2016",9,8614,188,8802,"Frontier Flights"
"1245","2016",10,8577,207,8784,"Frontier Flights"
"1246","2016",11,7707,426,8133,"Frontier Flights"
"1247","2016",12,7649,514,8163,"Frontier Flights"
"1248","2017",1,7609,536,8145,"Frontier Flights"
"1249","2017",2,6662,488,7150,"Frontier Flights"
"1250","2017",3,7657,538,8195,"Frontier Flights"
"1251","2017",4,7795,476,8271,"Frontier Flights"
"1252","2017",5,8622,400,9022,"Frontier Flights"
"1253","2017",6,8888,332,9220,"Frontier Flights"
"1254","2017",7,9569,338,9907,"Frontier Flights"
"1255","2017",8,9132,286,9418,"Frontier Flights"
"1256","2017",9,8401,246,8647,"Frontier Flights"
"1257","2017",10,9224,257,9481,"Frontier Flights"
"1258","2017",11,9139,460,9599,"Frontier Flights"
"1259","2017",12,9437,588,10025,"Frontier Flights"
"1260","2018",1,9549,609,10158,"Frontier Flights"
"1261","2018",2,8590,487,9077,"Frontier Flights"
"1262","2018",3,9200,532,9732,"Frontier Flights"
"1263","2018",4,9577,378,9955,"Frontier Flights"
"1264","2018",5,10257,345,10602,"Frontier Flights"
"1265","2018",6,9979,357,10336,"Frontier Flights"
"1266","2018",7,10290,370,10660,"Frontier Flights"
"1267","2018",8,10465,324,10789,"Frontier Flights"
"1268","2018",9,10054,265,10319,"Frontier Flights"
"1269","2018",10,10363,256,10619,"Frontier Flights"
"1270","2018",11,9498,373,9871,"Frontier Flights"
"1271","2018",12,9844,479,10323,"Frontier Flights"
"1272","2019",1,9500,561,10061,"Frontier Flights"
"1273","2019",2,8641,519,9160,"Frontier Flights"
"1274","2019",3,9661,588,10249,"Frontier Flights"
"1275","2019",4,9605,561,10166,"Frontier Flights"
"1276","2019",5,11282,474,11756,"Frontier Flights"
"1277","2019",6,11358,467,11825,"Frontier Flights"
"1278","2019",7,12263,484,12747,"Frontier Flights"
"1279","2019",8,12264,304,12568,"Frontier Flights"
"1280","2019",9,11893,195,12088,"Frontier Flights"
"1281","2019",10,12568,200,12768,"Frontier Flights"
"1282","2019",11,12146,302,12448,"Frontier Flights"
"1283","2019",12,12145,407,12552,"Frontier Flights"
"1284","2020",1,12319,511,12830,"Frontier Flights"
"1285","2020",2,11445,515,11960,"Frontier Flights"
"1286","2020",3,10011,457,10468,"Frontier Flights"
"1287","2020",4,1432,NA,1432,"Frontier Flights"
"1288","2020",5,2858,NA,2858,"Frontier Flights"
"1289","2020",6,4748,NA,4748,"Frontier Flights"
"1290","2020",7,7293,20,7313,"Frontier Flights"
"1291","2020",8,7069,72,7141,"Frontier Flights"
"1292","2020",9,6726,70,6796,"Frontier Flights"
"1293","2020",10,7897,74,7971,"Frontier Flights"
"1294","2020",11,7418,159,7577,"Frontier Flights"
"1295","2020",12,7296,262,7558,"Frontier Flights"
"1296","2021",1,6242,275,6517,"Frontier Flights"
"1297","2021",2,6482,354,6836,"Frontier Flights"
"1298","2021",3,10562,494,11056,"Frontier Flights"
"1299","2021",4,10828,543,11371,"Frontier Flights"
"1300","2021",5,11932,545,12477,"Frontier Flights"
"1301","2021",6,12471,800,13271,"Frontier Flights"
"1302","2021",7,13017,989,14006,"Frontier Flights"
"1303","2021",8,13094,765,13859,"Frontier Flights"
"1304","2021",9,12077,478,12555,"Frontier Flights"
"1305","2021",10,12911,587,13498,"Frontier Flights"
"1306","2021",11,12808,921,13729,"Frontier Flights"
"1307","2021",12,12943,1349,14292,"Frontier Flights"
"1308","2022",1,11506,1332,12838,"Frontier Flights"
"1309","2022",2,10656,1258,11914,"Frontier Flights"
"1310","2022",3,12317,1504,13821,"Frontier Flights"
"1311","2022",4,11783,1427,13210,"Frontier Flights"
"1312","2022",5,12490,1396,13886,"Frontier Flights"
"1313","2022",6,12294,1456,13750,"Frontier Flights"
"1314","2022",7,12992,1542,14534,"Frontier Flights"
"1315","2022",8,13206,1262,14468,"Frontier Flights"
"1316","2022",9,12945,661,13606,"Frontier Flights"
"1317","2022",10,14276,566,14842,"Frontier Flights"
"1318","2022",11,13389,875,14264,"Frontier Flights"
"1319","2022",12,13234,1071,14305,"Frontier Flights"
"1320","2023",1,12855,1112,13967,"Frontier Flights"
"1321","2023",2,12333,1018,13351,"Frontier Flights"
"1322","2023",3,14246,1143,15389,"Frontier Flights"
"1323","2023",4,13569,1160,14729,"Frontier Flights"
"1324","2023",5,13951,1562,15513,"Frontier Flights"
"1325","2023",6,13401,1769,15170,"Frontier Flights"
"1326","2023",7,14125,1775,15900,"Frontier Flights"
"1327","2023",8,14639,1383,16022,"Frontier Flights"
"1328","2023",9,16025,679,16704,"Frontier Flights"
"1329","2023",10,17151,709,17860,"Frontier Flights"
"1330","2023",11,15899,1109,17008,"Frontier Flights"
"1331","2023",12,15615,1615,17230,"Frontier Flights"
"1332","2024",1,14059,1485,15544,"Frontier Flights"
"1333","2024",2,14117,1083,15200,"Frontier Flights"
"1334","2024",3,16855,1064,17919,"Frontier Flights"
"1335","2024",4,16793,1256,18049,"Frontier Flights"
"1336","2024",5,18151,1513,19664,"Frontier Flights"
"1337","2024",6,17983,1469,19452,"Frontier Flights"
"1338","2024",7,18623,1466,20089,"Frontier Flights"
"1339","2024",8,18268,839,19107,"Frontier Flights"
"1340","2024",9,17230,307,17537,"Frontier Flights"
"1341","2024",10,17259,356,17615,"Frontier Flights"
"1342","2024",11,17455,551,18006,"Frontier Flights"
"1343","2024",12,17212,975,18187,"Frontier Flights"
"1344","2025",1,15157,719,15876,"Frontier Flights"
"1345","2002",10,60691,4097,64788,"Delta Flights"
"1346","2002",11,57316,3822,61138,"Delta Flights"
"1347","2002",12,58234,3851,62085,"Delta Flights"
"1348","2003",1,59177,3822,62999,"Delta Flights"
"1349","2003",2,51166,3168,54334,"Delta Flights"
"1350","2003",3,57904,3619,61523,"Delta Flights"
"1351","2003",4,51740,3284,55024,"Delta Flights"
"1352","2003",5,52123,3320,55443,"Delta Flights"
"1353","2003",6,53524,3694,57218,"Delta Flights"
"1354","2003",7,55080,3885,58965,"Delta Flights"
"1355","2003",8,55822,4049,59871,"Delta Flights"
"1356","2003",9,53629,3900,57529,"Delta Flights"
"1357","2003",10,56374,3832,60206,"Delta Flights"
"1358","2003",11,54121,3619,57740,"Delta Flights"
"1359","2003",12,55768,3854,59622,"Delta Flights"
"1360","2004",1,55623,3758,59381,"Delta Flights"
"1361","2004",2,53479,3424,56903,"Delta Flights"
"1362","2004",3,58574,3692,62266,"Delta Flights"
"1363","2004",4,57034,4047,61081,"Delta Flights"
"1364","2004",5,58122,4346,62468,"Delta Flights"
"1365","2004",6,57390,4437,61827,"Delta Flights"
"1366","2004",7,58209,4619,62828,"Delta Flights"
"1367","2004",8,58254,4597,62851,"Delta Flights"
"1368","2004",9,52800,4326,57126,"Delta Flights"
"1369","2004",10,57833,4227,62060,"Delta Flights"
"1370","2004",11,55673,3909,59582,"Delta Flights"
"1371","2004",12,56593,4392,60985,"Delta Flights"
"1372","2005",1,54831,4336,59167,"Delta Flights"
"1373","2005",2,54023,3947,57970,"Delta Flights"
"1374","2005",3,59503,4658,64161,"Delta Flights"
"1375","2005",4,57192,4575,61767,"Delta Flights"
"1376","2005",5,58405,4891,63296,"Delta Flights"
"1377","2005",6,55511,4927,60438,"Delta Flights"
"1378","2005",7,56553,5165,61718,"Delta Flights"
"1379","2005",8,56616,5153,61769,"Delta Flights"
"1380","2005",9,48208,4903,53111,"Delta Flights"
"1381","2005",10,49981,4759,54740,"Delta Flights"
"1382","2005",11,47534,4303,51837,"Delta Flights"
"1383","2005",12,44871,5018,49889,"Delta Flights"
"1384","2006",1,44210,4933,49143,"Delta Flights"
"1385","2006",2,39463,4330,43793,"Delta Flights"
"1386","2006",3,45366,5471,50837,"Delta Flights"
"1387","2006",4,42586,5395,47981,"Delta Flights"
"1388","2006",5,41606,5726,47332,"Delta Flights"
"1389","2006",6,41545,6439,47984,"Delta Flights"
"1390","2006",7,42284,6922,49206,"Delta Flights"
"1391","2006",8,42765,6700,49465,"Delta Flights"
"1392","2006",9,39315,5495,44810,"Delta Flights"
"1393","2006",10,41557,5440,46997,"Delta Flights"
"1394","2006",11,40207,5206,45413,"Delta Flights"
"1395","2006",12,40000,6222,46222,"Delta Flights"
"1396","2007",1,38888,6229,45117,"Delta Flights"
"1397","2007",2,34898,5535,40433,"Delta Flights"
"1398","2007",3,40552,6433,46985,"Delta Flights"
"1399","2007",4,38728,6214,44942,"Delta Flights"
"1400","2007",5,38780,6396,45176,"Delta Flights"
"1401","2007",6,39831,7226,47057,"Delta Flights"
"1402","2007",7,41191,7631,48822,"Delta Flights"
"1403","2007",8,41585,7303,48888,"Delta Flights"
"1404","2007",9,38688,5855,44543,"Delta Flights"
"1405","2007",10,41106,5599,46705,"Delta Flights"
"1406","2007",11,39377,5564,44941,"Delta Flights"
"1407","2007",12,38668,6312,44980,"Delta Flights"
"1408","2008",1,37298,6101,43399,"Delta Flights"
"1409","2008",2,35935,5704,41639,"Delta Flights"
"1410","2008",3,39305,6586,45891,"Delta Flights"
"1411","2008",4,36967,6236,43203,"Delta Flights"
"1412","2008",5,36387,6594,42981,"Delta Flights"
"1413","2008",6,37670,7485,45155,"Delta Flights"
"1414","2008",7,38839,8256,47095,"Delta Flights"
"1415","2008",8,37836,7792,45628,"Delta Flights"
"1416","2008",9,36029,6041,42070,"Delta Flights"
"1417","2008",10,38549,5862,44411,"Delta Flights"
"1418","2008",11,36823,5711,42534,"Delta Flights"
"1419","2008",12,36565,6704,43269,"Delta Flights"
"1420","2009",1,35727,6383,42110,"Delta Flights"
"1421","2009",2,32459,5627,38086,"Delta Flights"
"1422","2009",3,35907,6454,42361,"Delta Flights"
"1423","2009",4,35136,6262,41398,"Delta Flights"
"1424","2009",5,35284,6314,41598,"Delta Flights"
"1425","2009",6,35385,7354,42739,"Delta Flights"
"1426","2009",7,37119,7903,45022,"Delta Flights"
"1427","2009",8,37139,7333,44472,"Delta Flights"
"1428","2009",9,34613,5894,40507,"Delta Flights"
"1429","2009",10,36563,5725,42288,"Delta Flights"
"1430","2009",11,35600,5489,41089,"Delta Flights"
"1431","2009",12,34582,6656,41238,"Delta Flights"
"1432","2010",1,56061,9321,65382,"Delta Flights"
"1433","2010",2,50092,8488,58580,"Delta Flights"
"1434","2010",3,59690,9838,69528,"Delta Flights"
"1435","2010",4,59271,8602,67873,"Delta Flights"
"1436","2010",5,61027,9228,70255,"Delta Flights"
"1437","2010",6,63222,10570,73792,"Delta Flights"
"1438","2010",7,64478,11484,75962,"Delta Flights"
"1439","2010",8,65066,10848,75914,"Delta Flights"
"1440","2010",9,61372,8654,70026,"Delta Flights"
"1441","2010",10,63029,8708,71737,"Delta Flights"
"1442","2010",11,59859,7999,67858,"Delta Flights"
"1443","2010",12,58350,8922,67272,"Delta Flights"
"1444","2011",1,55852,9433,65285,"Delta Flights"
"1445","2011",2,52259,8869,61128,"Delta Flights"
"1446","2011",3,62311,10527,72838,"Delta Flights"
"1447","2011",4,60131,9647,69778,"Delta Flights"
"1448","2011",5,62865,9475,72340,"Delta Flights"
"1449","2011",6,63783,10520,74303,"Delta Flights"
"1450","2011",7,66539,11461,78000,"Delta Flights"
"1451","2011",8,65237,10709,75946,"Delta Flights"
"1452","2011",9,59226,8689,67915,"Delta Flights"
"1453","2011",10,61212,8513,69725,"Delta Flights"
"1454","2011",11,58129,7452,65581,"Delta Flights"
"1455","2011",12,57426,8642,66068,"Delta Flights"
"1456","2012",1,55239,8871,64110,"Delta Flights"
"1457","2012",2,52037,8635,60672,"Delta Flights"
"1458","2012",3,60472,10356,70828,"Delta Flights"
"1459","2012",4,59461,9173,68634,"Delta Flights"
"1460","2012",5,61301,9524,70825,"Delta Flights"
"1461","2012",6,63297,10560,73857,"Delta Flights"
"1462","2012",7,65771,11131,76902,"Delta Flights"
"1463","2012",8,66746,10697,77443,"Delta Flights"
"1464","2012",9,61144,8796,69940,"Delta Flights"
"1465","2012",10,62824,8417,71241,"Delta Flights"
"1466","2012",11,60032,7657,67689,"Delta Flights"
"1467","2012",12,57389,8852,66241,"Delta Flights"
"1468","2013",1,57081,8683,65764,"Delta Flights"
"1469","2013",2,52443,8262,60705,"Delta Flights"
"1470","2013",3,63624,10018,73642,"Delta Flights"
"1471","2013",4,62354,9099,71453,"Delta Flights"
"1472","2013",5,64207,9717,73924,"Delta Flights"
"1473","2013",6,66266,10866,77132,"Delta Flights"
"1474","2013",7,69227,11927,81154,"Delta Flights"
"1475","2013",8,69479,11667,81146,"Delta Flights"
"1476","2013",9,62388,9669,72057,"Delta Flights"
"1477","2013",10,65587,9294,74881,"Delta Flights"
"1478","2013",11,61500,8654,70154,"Delta Flights"
"1479","2013",12,60717,9730,70447,"Delta Flights"
"1480","2014",1,56300,9944,66244,"Delta Flights"
"1481","2014",2,51726,9056,60782,"Delta Flights"
"1482","2014",3,67085,11108,78193,"Delta Flights"
"1483","2014",4,65806,10012,75818,"Delta Flights"
"1484","2014",5,68221,10613,78834,"Delta Flights"
"1485","2014",6,69904,11942,81846,"Delta Flights"
"1486","2014",7,72875,12804,85679,"Delta Flights"
"1487","2014",8,72902,12746,85648,"Delta Flights"
"1488","2014",9,67122,10459,77581,"Delta Flights"
"1489","2014",10,70812,9911,80723,"Delta Flights"
"1490","2014",11,67079,9173,76252,"Delta Flights"
"1491","2014",12,66621,10575,77196,"Delta Flights"
"1492","2015",1,63957,11441,75398,"Delta Flights"
"1493","2015",2,59378,9983,69361,"Delta Flights"
"1494","2015",3,73836,11797,85633,"Delta Flights"
"1495","2015",4,72219,11181,83400,"Delta Flights"
"1496","2015",5,74937,11743,86680,"Delta Flights"
"1497","2015",6,77368,12580,89948,"Delta Flights"
"1498","2015",7,80943,13462,94405,"Delta Flights"
"1499","2015",8,81178,13450,94628,"Delta Flights"
"1500","2015",9,72242,10808,83050,"Delta Flights"
"1501","2015",10,75652,10098,85750,"Delta Flights"
"1502","2015",11,72350,9395,81745,"Delta Flights"
"1503","2015",12,70846,10920,81766,"Delta Flights"
"1504","2016",1,68903,11834,80737,"Delta Flights"
"1505","2016",2,67661,10744,78405,"Delta Flights"
"1506","2016",3,78326,11733,90059,"Delta Flights"
"1507","2016",4,76677,11525,88202,"Delta Flights"
"1508","2016",5,80644,11884,92528,"Delta Flights"
"1509","2016",6,81770,12641,94411,"Delta Flights"
"1510","2016",7,83844,13534,97378,"Delta Flights"
"1511","2016",8,82950,13175,96125,"Delta Flights"
"1512","2016",9,75632,10963,86595,"Delta Flights"
"1513","2016",10,78599,10312,88911,"Delta Flights"
"1514","2016",11,74194,9061,83255,"Delta Flights"
"1515","2016",12,71642,11509,83151,"Delta Flights"
"1516","2017",1,69354,12069,81423,"Delta Flights"
"1517","2017",2,65129,10496,75625,"Delta Flights"
"1518","2017",3,78839,12290,91129,"Delta Flights"
"1519","2017",4,74141,12094,86235,"Delta Flights"
"1520","2017",5,80904,12492,93396,"Delta Flights"
"1521","2017",6,81187,13265,94452,"Delta Flights"
"1522","2017",7,83843,14066,97909,"Delta Flights"
"1523","2017",8,84816,13687,98503,"Delta Flights"
"1524","2017",9,74074,11305,85379,"Delta Flights"
"1525","2017",10,79605,11038,90643,"Delta Flights"
"1526","2017",11,74440,9763,84203,"Delta Flights"
"1527","2017",12,70899,11730,82629,"Delta Flights"
"1528","2018",1,69959,12395,82354,"Delta Flights"
"1529","2018",2,66400,10979,77379,"Delta Flights"
"1530","2018",3,80645,12813,93458,"Delta Flights"
"1531","2018",4,78895,12102,90997,"Delta Flights"
"1532","2018",5,81914,12729,94643,"Delta Flights"
"1533","2018",6,83840,13481,97321,"Delta Flights"
"1534","2018",7,86766,14228,100994,"Delta Flights"
"1535","2018",8,88074,13812,101886,"Delta Flights"
"1536","2018",9,78175,11620,89795,"Delta Flights"
"1537","2018",10,82219,11267,93486,"Delta Flights"
"1538","2018",11,76362,9959,86321,"Delta Flights"
"1539","2018",12,75133,11563,86696,"Delta Flights"
"1540","2019",1,73774,12201,85975,"Delta Flights"
"1541","2019",2,67498,10950,78448,"Delta Flights"
"1542","2019",3,84277,12821,97098,"Delta Flights"
"1543","2019",4,81982,12271,94253,"Delta Flights"
"1544","2019",5,85854,13105,98959,"Delta Flights"
"1545","2019",6,87557,13582,101139,"Delta Flights"
"1546","2019",7,90848,14052,104900,"Delta Flights"
"1547","2019",8,91358,14059,105417,"Delta Flights"
"1548","2019",9,81601,12186,93787,"Delta Flights"
"1549","2019",10,86493,11821,98314,"Delta Flights"
"1550","2019",11,80078,10159,90237,"Delta Flights"
"1551","2019",12,81702,11720,93422,"Delta Flights"
"1552","2020",1,80201,12496,92697,"Delta Flights"
"1553","2020",2,75595,11032,86627,"Delta Flights"
"1554","2020",3,66956,8092,75048,"Delta Flights"
"1555","2020",4,19124,465,19589,"Delta Flights"
"1556","2020",5,16970,409,17379,"Delta Flights"
"1557","2020",6,21892,749,22641,"Delta Flights"
"1558","2020",7,36947,2019,38966,"Delta Flights"
"1559","2020",8,47472,2745,50217,"Delta Flights"
"1560","2020",9,44289,2973,47262,"Delta Flights"
"1561","2020",10,46812,3909,50721,"Delta Flights"
"1562","2020",11,48481,4629,53110,"Delta Flights"
"1563","2020",12,48898,6383,55281,"Delta Flights"
"1564","2021",1,48209,7229,55438,"Delta Flights"
"1565","2021",2,42957,6112,49069,"Delta Flights"
"1566","2021",3,55788,6737,62525,"Delta Flights"
"1567","2021",4,55244,6525,61769,"Delta Flights"
"1568","2021",5,61208,6817,68025,"Delta Flights"
"1569","2021",6,66069,6766,72835,"Delta Flights"
"1570","2021",7,70230,7341,77571,"Delta Flights"
"1571","2021",8,70760,7633,78393,"Delta Flights"
"1572","2021",9,67405,6840,74245,"Delta Flights"
"1573","2021",10,70593,6803,77396,"Delta Flights"
"1574","2021",11,70414,6735,77149,"Delta Flights"
"1575","2021",12,67073,7876,74949,"Delta Flights"
"1576","2022",1,66909,8451,75360,"Delta Flights"
"1577","2022",2,61955,7628,69583,"Delta Flights"
"1578","2022",3,75102,8942,84044,"Delta Flights"
"1579","2022",4,72443,8786,81229,"Delta Flights"
"1580","2022",5,74273,9474,83747,"Delta Flights"
"1581","2022",6,74180,10209,84389,"Delta Flights"
"1582","2022",7,78183,10268,88451,"Delta Flights"
"1583","2022",8,78313,10209,88522,"Delta Flights"
"1584","2022",9,74145,9320,83465,"Delta Flights"
"1585","2022",10,75747,9382,85129,"Delta Flights"
"1586","2022",11,75511,8544,84055,"Delta Flights"
"1587","2022",12,74079,9778,83857,"Delta Flights"
"1588","2023",1,74801,10619,85420,"Delta Flights"
"1589","2023",2,68335,9282,77617,"Delta Flights"
"1590","2023",3,81444,11166,92610,"Delta Flights"
"1591","2023",4,78596,11172,89768,"Delta Flights"
"1592","2023",5,84165,11567,95732,"Delta Flights"
"1593","2023",6,85002,11848,96850,"Delta Flights"
"1594","2023",7,88794,12473,101267,"Delta Flights"
"1595","2023",8,87924,11953,99877,"Delta Flights"
"1596","2023",9,81488,11107,92595,"Delta Flights"
"1597","2023",10,85386,11030,96416,"Delta Flights"
"1598","2023",11,80446,10098,90544,"Delta Flights"
"1599","2023",12,81111,12082,93193,"Delta Flights"
"1600","2024",1,74144,12097,86241,"Delta Flights"
"1601","2024",2,71241,11065,82306,"Delta Flights"
"1602","2024",3,82712,12844,95556,"Delta Flights"
"1603","2024",4,82858,12285,95143,"Delta Flights"
"1604","2024",5,88510,12266,100776,"Delta Flights"
"1605","2024",6,89168,12648,101816,"Delta Flights"
"1606","2024",7,86701,12787,99488,"Delta Flights"
"1607","2024",8,89979,12624,102603,"Delta Flights"
"1608","2024",9,84370,11561,95931,"Delta Flights"
"1609","2024",10,87583,11329,98912,"Delta Flights"
"1610","2024",11,81900,10075,91975,"Delta Flights"
"1611","2024",12,83396,12421,95817,"Delta Flights"
"1612","2025",1,74354,12566,86920,"Delta Flights"
"1613","2002",10,51504,4798,56302,"United Flights"
"1614","2002",11,46067,4525,50592,"United Flights"
"1615","2002",12,48260,4684,52944,"United Flights"
"1616","2003",1,47193,4580,51773,"United Flights"
"1617","2003",2,41776,4018,45794,"United Flights"
"1618","2003",3,46287,4464,50751,"United Flights"
"1619","2003",4,42749,3748,46497,"United Flights"
"1620","2003",5,43390,3858,47248,"United Flights"
"1621","2003",6,44730,4238,48968,"United Flights"
"1622","2003",7,47409,4658,52067,"United Flights"
"1623","2003",8,46975,4796,51771,"United Flights"
"1624","2003",9,43644,4387,48031,"United Flights"
"1625","2003",10,45746,4500,50246,"United Flights"
"1626","2003",11,43582,4135,47717,"United Flights"
"1627","2003",12,45727,4322,50049,"United Flights"
"1628","2004",1,44862,4373,49235,"United Flights"
"1629","2004",2,42416,4124,46540,"United Flights"
"1630","2004",3,46260,4439,50699,"United Flights"
"1631","2004",4,45207,4343,49550,"United Flights"
"1632","2004",5,46183,4414,50597,"United Flights"
"1633","2004",6,47229,4678,51907,"United Flights"
"1634","2004",7,49445,4934,54379,"United Flights"
"1635","2004",8,50306,4924,55230,"United Flights"
"1636","2004",9,45137,4615,49752,"United Flights"
"1637","2004",10,46690,4700,51390,"United Flights"
"1638","2004",11,42781,4496,47277,"United Flights"
"1639","2004",12,43953,4897,48850,"United Flights"
"1640","2005",1,40487,5139,45626,"United Flights"
"1641","2005",2,36947,4642,41589,"United Flights"
"1642","2005",3,40525,5137,45662,"United Flights"
"1643","2005",4,38477,5076,43553,"United Flights"
"1644","2005",5,40666,5098,45764,"United Flights"
"1645","2005",6,40624,5054,45678,"United Flights"
"1646","2005",7,41718,5277,46995,"United Flights"
"1647","2005",8,41723,5252,46975,"United Flights"
"1648","2005",9,39059,4752,43811,"United Flights"
"1649","2005",10,40481,4932,45413,"United Flights"
"1650","2005",11,39500,4445,43945,"United Flights"
"1651","2005",12,40621,5028,45649,"United Flights"
"1652","2006",1,39616,5225,44841,"United Flights"
"1653","2006",2,37062,4738,41800,"United Flights"
"1654","2006",3,41874,5275,47149,"United Flights"
"1655","2006",4,40349,5262,45611,"United Flights"
"1656","2006",5,42131,5274,47405,"United Flights"
"1657","2006",6,41610,5429,47039,"United Flights"
"1658","2006",7,42593,5787,48380,"United Flights"
"1659","2006",8,43619,5803,49422,"United Flights"
"1660","2006",9,40264,5116,45380,"United Flights"
"1661","2006",10,41826,5146,46972,"United Flights"
"1662","2006",11,40356,5062,45418,"United Flights"
"1663","2006",12,39961,5353,45314,"United Flights"
"1664","2007",1,40730,5276,46006,"United Flights"
"1665","2007",2,35901,4740,40641,"United Flights"
"1666","2007",3,41911,5475,47386,"United Flights"
"1667","2007",4,39940,5310,45250,"United Flights"
"1668","2007",5,41276,5386,46662,"United Flights"
"1669","2007",6,40370,5538,45908,"United Flights"
"1670","2007",7,41793,5767,47560,"United Flights"
"1671","2007",8,42221,5768,47989,"United Flights"
"1672","2007",9,38698,5137,43835,"United Flights"
"1673","2007",10,40600,5289,45889,"United Flights"
"1674","2007",11,38337,4999,43336,"United Flights"
"1675","2007",12,37883,5476,43359,"United Flights"
"1676","2008",1,36672,5574,42246,"United Flights"
"1677","2008",2,35408,5209,40617,"United Flights"
"1678","2008",3,39680,5630,45310,"United Flights"
"1679","2008",4,38296,5452,43748,"United Flights"
"1680","2008",5,39291,5497,44788,"United Flights"
"1681","2008",6,39314,5534,44848,"United Flights"
"1682","2008",7,40267,5723,45990,"United Flights"
"1683","2008",8,39694,5777,45471,"United Flights"
"1684","2008",9,34238,4878,39116,"United Flights"
"1685","2008",10,35313,4903,40216,"United Flights"
"1686","2008",11,30843,4506,35349,"United Flights"
"1687","2008",12,31894,4907,36801,"United Flights"
"1688","2009",1,30875,4917,35792,"United Flights"
"1689","2009",2,29456,4376,33832,"United Flights"
"1690","2009",3,33946,4977,38923,"United Flights"
"1691","2009",4,30970,5035,36005,"United Flights"
"1692","2009",5,31517,4749,36266,"United Flights"
"1693","2009",6,32563,4918,37481,"United Flights"
"1694","2009",7,33582,5175,38757,"United Flights"
"1695","2009",8,33285,5158,38443,"United Flights"
"1696","2009",9,29685,4445,34130,"United Flights"
"1697","2009",10,30299,4391,34690,"United Flights"
"1698","2009",11,27613,4005,31618,"United Flights"
"1699","2009",12,28448,4318,32766,"United Flights"
"1700","2010",1,27713,4541,32254,"United Flights"
"1701","2010",2,24772,3912,28684,"United Flights"
"1702","2010",3,29373,4632,34005,"United Flights"
"1703","2010",4,28081,4237,32318,"United Flights"
"1704","2010",5,28740,4665,33405,"United Flights"
"1705","2010",6,29090,4692,33782,"United Flights"
"1706","2010",7,30224,4973,35197,"United Flights"
"1707","2010",8,30444,4866,35310,"United Flights"
"1708","2010",9,27980,4362,32342,"United Flights"
"1709","2010",10,29057,4535,33592,"United Flights"
"1710","2010",11,27263,4133,31396,"United Flights"
"1711","2010",12,27172,4597,31769,"United Flights"
"1712","2011",1,25702,4738,30440,"United Flights"
"1713","2011",2,23216,4242,27458,"United Flights"
"1714","2011",3,27359,5053,32412,"United Flights"
"1715","2011",4,25052,5117,30169,"United Flights"
"1716","2011",5,25809,5052,30861,"United Flights"
"1717","2011",6,27382,4942,32324,"United Flights"
"1718","2011",7,28530,5227,33757,"United Flights"
"1719","2011",8,28180,5051,33231,"United Flights"
"1720","2011",9,24571,4629,29200,"United Flights"
"1721","2011",10,25040,4672,29712,"United Flights"
"1722","2011",11,22893,4204,27097,"United Flights"
"1723","2011",12,23895,4688,28583,"United Flights"
"1724","2012",1,41370,13434,54804,"United Flights"
"1725","2012",2,40632,12589,53221,"United Flights"
"1726","2012",3,46149,14525,60674,"United Flights"
"1727","2012",4,44170,13675,57845,"United Flights"
"1728","2012",5,45115,13843,58958,"United Flights"
"1729","2012",6,46479,14148,60627,"United Flights"
"1730","2012",7,47403,15160,62563,"United Flights"
"1731","2012",8,47361,14224,61585,"United Flights"
"1732","2012",9,42756,11781,54537,"United Flights"
"1733","2012",10,42550,11489,54039,"United Flights"
"1734","2012",11,40882,11056,51938,"United Flights"
"1735","2012",12,41814,12480,54294,"United Flights"
"1736","2013",1,40335,12973,53308,"United Flights"
"1737","2013",2,37435,11511,48946,"United Flights"
"1738","2013",3,43624,13905,57529,"United Flights"
"1739","2013",4,41144,13393,54537,"United Flights"
"1740","2013",5,42916,13561,56477,"United Flights"
"1741","2013",6,43326,14053,57379,"United Flights"
"1742","2013",7,44467,14804,59271,"United Flights"
"1743","2013",8,44455,14087,58542,"United Flights"
"1744","2013",9,40645,11825,52470,"United Flights"
"1745","2013",10,43239,11792,55031,"United Flights"
"1746","2013",11,40550,11476,52026,"United Flights"
"1747","2013",12,41074,12548,53622,"United Flights"
"1748","2014",1,37555,12807,50362,"United Flights"
"1749","2014",2,35274,11676,46950,"United Flights"
"1750","2014",3,42232,14895,57127,"United Flights"
"1751","2014",4,39498,13498,52996,"United Flights"
"1752","2014",5,42239,14022,56261,"United Flights"
"1753","2014",6,42596,15001,57597,"United Flights"
"1754","2014",7,43775,15661,59436,"United Flights"
"1755","2014",8,42721,14631,57352,"United Flights"
"1756","2014",9,39951,11666,51617,"United Flights"
"1757","2014",10,43231,11875,55106,"United Flights"
"1758","2014",11,39686,12022,51708,"United Flights"
"1759","2014",12,40276,13261,53537,"United Flights"
"1760","2015",1,37607,12789,50396,"United Flights"
"1761","2015",2,35454,11470,46924,"United Flights"
"1762","2015",3,43230,14507,57737,"United Flights"
"1763","2015",4,41165,14267,55432,"United Flights"
"1764","2015",5,44396,13941,58337,"United Flights"
"1765","2015",6,45385,14663,60048,"United Flights"
"1766","2015",7,46250,16216,62466,"United Flights"
"1767","2015",8,45328,15194,60522,"United Flights"
"1768","2015",9,41774,11744,53518,"United Flights"
"1769","2015",10,45892,11731,57623,"United Flights"
"1770","2015",11,42495,12053,54548,"United Flights"
"1771","2015",12,42855,13886,56741,"United Flights"
"1772","2016",1,38556,13177,51733,"United Flights"
"1773","2016",2,38677,12400,51077,"United Flights"
"1774","2016",3,43911,14625,58536,"United Flights"
"1775","2016",4,42781,13299,56080,"United Flights"
"1776","2016",5,45910,13833,59743,"United Flights"
"1777","2016",6,46399,14880,61279,"United Flights"
"1778","2016",7,47857,16342,64199,"United Flights"
"1779","2016",8,49703,14750,64453,"United Flights"
"1780","2016",9,46870,11865,58735,"United Flights"
"1781","2016",10,49691,11893,61584,"United Flights"
"1782","2016",11,46043,11545,57588,"United Flights"
"1783","2016",12,45329,14090,59419,"United Flights"
"1784","2017",1,42317,13837,56154,"United Flights"
"1785","2017",2,39735,12089,51824,"United Flights"
"1786","2017",3,47941,14528,62469,"United Flights"
"1787","2017",4,45622,14107,59729,"United Flights"
"1788","2017",5,49466,14302,63768,"United Flights"
"1789","2017",6,51968,15580,67548,"United Flights"
"1790","2017",7,53430,16850,70280,"United Flights"
"1791","2017",8,53531,14762,68293,"United Flights"
"1792","2017",9,47547,12422,59969,"United Flights"
"1793","2017",10,51239,12640,63879,"United Flights"
"1794","2017",11,48381,12489,60870,"United Flights"
"1795","2017",12,49116,13972,63088,"United Flights"
"1796","2018",1,44638,13513,58151,"United Flights"
"1797","2018",2,41611,12058,53669,"United Flights"
"1798","2018",3,48896,14670,63566,"United Flights"
"1799","2018",4,49966,13722,63688,"United Flights"
"1800","2018",5,52779,13567,66346,"United Flights"
"1801","2018",6,55024,15145,70169,"United Flights"
"1802","2018",7,57157,16212,73369,"United Flights"
"1803","2018",8,57536,14903,72439,"United Flights"
"1804","2018",9,52837,12025,64862,"United Flights"
"1805","2018",10,55635,12494,68129,"United Flights"
"1806","2018",11,51388,12403,63791,"United Flights"
"1807","2018",12,51589,14276,65865,"United Flights"
"1808","2019",1,46338,13826,60164,"United Flights"
"1809","2019",2,43605,12262,55867,"United Flights"
"1810","2019",3,53156,14753,67909,"United Flights"
"1811","2019",4,51932,14164,66096,"United Flights"
"1812","2019",5,54291,14381,68672,"United Flights"
"1813","2019",6,54112,16063,70175,"United Flights"
"1814","2019",7,55791,16693,72484,"United Flights"
"1815","2019",8,55966,15569,71535,"United Flights"
"1816","2019",9,51416,12900,64316,"United Flights"
"1817","2019",10,55041,13123,68164,"United Flights"
"1818","2019",11,49995,13443,63438,"United Flights"
"1819","2019",12,51295,14887,66182,"United Flights"
"1820","2020",1,48248,14114,62362,"United Flights"
"1821","2020",2,46225,12454,58679,"United Flights"
"1822","2020",3,41503,9832,51335,"United Flights"
"1823","2020",4,8998,744,9742,"United Flights"
"1824","2020",5,7065,737,7802,"United Flights"
"1825","2020",6,7300,1124,8424,"United Flights"
"1826","2020",7,14958,2320,17278,"United Flights"
"1827","2020",8,21403,3534,24937,"United Flights"
"1828","2020",9,17230,3688,20918,"United Flights"
"1829","2020",10,23560,4492,28052,"United Flights"
"1830","2020",11,24161,6001,30162,"United Flights"
"1831","2020",12,25618,7881,33499,"United Flights"
"1832","2021",1,23849,7588,31437,"United Flights"
"1833","2021",2,21276,6006,27282,"United Flights"
"1834","2021",3,28290,7663,35953,"United Flights"
"1835","2021",4,27825,7679,35504,"United Flights"
"1836","2021",5,31041,8779,39820,"United Flights"
"1837","2021",6,35933,10276,46209,"United Flights"
"1838","2021",7,43131,11545,54676,"United Flights"
"1839","2021",8,44389,11699,56088,"United Flights"
"1840","2021",9,43957,9998,53955,"United Flights"
"1841","2021",10,47647,10245,57892,"United Flights"
"1842","2021",11,47054,10867,57921,"United Flights"
"1843","2021",12,48081,12132,60213,"United Flights"
"1844","2022",1,42989,11519,54508,"United Flights"
"1845","2022",2,43165,10081,53246,"United Flights"
"1846","2022",3,50705,12123,62828,"United Flights"
"1847","2022",4,49026,12871,61897,"United Flights"
"1848","2022",5,52854,13658,66512,"United Flights"
"1849","2022",6,51637,14957,66594,"United Flights"
"1850","2022",7,54955,16060,71015,"United Flights"
"1851","2022",8,54065,15136,69201,"United Flights"
"1852","2022",9,50493,12690,63183,"United Flights"
"1853","2022",10,56345,12287,68632,"United Flights"
"1854","2022",11,53479,12502,65981,"United Flights"
"1855","2022",12,57173,14057,71230,"United Flights"
"1856","2023",1,56455,13260,69715,"United Flights"
"1857","2023",2,53119,11985,65104,"United Flights"
"1858","2023",3,61358,14488,75846,"United Flights"
"1859","2023",4,57206,15232,72438,"United Flights"
"1860","2023",5,62093,15572,77665,"United Flights"
"1861","2023",6,59448,16748,76196,"United Flights"
"1862","2023",7,62986,17872,80858,"United Flights"
"1863","2023",8,66247,17646,83893,"United Flights"
"1864","2023",9,61990,15031,77021,"United Flights"
"1865","2023",10,65838,15027,80865,"United Flights"
"1866","2023",11,57913,15045,72958,"United Flights"
"1867","2023",12,59888,16860,76748,"United Flights"
"1868","2024",1,54451,16170,70621,"United Flights"
"1869","2024",2,56656,15271,71927,"United Flights"
"1870","2024",3,64773,17433,82206,"United Flights"
"1871","2024",4,60905,17827,78732,"United Flights"
"1872","2024",5,63749,18594,82343,"United Flights"
"1873","2024",6,62566,19551,82117,"United Flights"
"1874","2024",7,63452,20133,83585,"United Flights"
"1875","2024",8,65070,19321,84391,"United Flights"
"1876","2024",9,63986,16411,80397,"United Flights"
"1877","2024",10,67956,16371,84327,"United Flights"
"1878","2024",11,63508,16056,79564,"United Flights"
"1879","2024",12,63872,18270,82142,"United Flights"
"1880","2025",1,61015,16581,77596,"United Flights"
"1881","2002",10,12931,1482,14413,"Alaskan Flights"
"1882","2002",11,12004,1795,13799,"Alaskan Flights"
"1883","2002",12,12627,1865,14492,"Alaskan Flights"
"1884","2003",1,12421,1799,14220,"Alaskan Flights"
"1885","2003",2,11151,1673,12824,"Alaskan Flights"
"1886","2003",3,12551,1878,14429,"Alaskan Flights"
"1887","2003",4,12510,1765,14275,"Alaskan Flights"
"1888","2003",5,13508,1541,15049,"Alaskan Flights"
"1889","2003",6,14557,1546,16103,"Alaskan Flights"
"1890","2003",7,15488,1675,17163,"Alaskan Flights"
"1891","2003",8,15432,1690,17122,"Alaskan Flights"
"1892","2003",9,13419,1400,14819,"Alaskan Flights"
"1893","2003",10,13450,1487,14937,"Alaskan Flights"
"1894","2003",11,12581,1752,14333,"Alaskan Flights"
"1895","2003",12,13257,1833,15090,"Alaskan Flights"
"1896","2004",1,12314,1796,14110,"Alaskan Flights"
"1897","2004",2,12259,1699,13958,"Alaskan Flights"
"1898","2004",3,13481,1823,15304,"Alaskan Flights"
"1899","2004",4,13176,1707,14883,"Alaskan Flights"
"1900","2004",5,14048,1503,15551,"Alaskan Flights"
"1901","2004",6,14600,1589,16189,"Alaskan Flights"
"1902","2004",7,15454,1690,17144,"Alaskan Flights"
"1903","2004",8,15401,1691,17092,"Alaskan Flights"
"1904","2004",9,13656,1470,15126,"Alaskan Flights"
"1905","2004",10,13534,1456,14990,"Alaskan Flights"
"1906","2004",11,12701,1760,14461,"Alaskan Flights"
"1907","2004",12,13096,1806,14902,"Alaskan Flights"
"1908","2005",1,12796,1783,14579,"Alaskan Flights"
"1909","2005",2,11770,1674,13444,"Alaskan Flights"
"1910","2005",3,13065,1926,14991,"Alaskan Flights"
"1911","2005",4,12534,1867,14401,"Alaskan Flights"
"1912","2005",5,12522,1669,14191,"Alaskan Flights"
"1913","2005",6,13417,1516,14933,"Alaskan Flights"
"1914","2005",7,14251,1569,15820,"Alaskan Flights"
"1915","2005",8,14263,1695,15958,"Alaskan Flights"
"1916","2005",9,13021,1537,14558,"Alaskan Flights"
"1917","2005",10,13116,1546,14662,"Alaskan Flights"
"1918","2005",11,12304,1860,14164,"Alaskan Flights"
"1919","2005",12,12772,1954,14726,"Alaskan Flights"
"1920","2006",1,12572,1979,14551,"Alaskan Flights"
"1921","2006",2,11397,1750,13147,"Alaskan Flights"
"1922","2006",3,12946,1970,14916,"Alaskan Flights"
"1923","2006",4,12630,1901,14531,"Alaskan Flights"
"1924","2006",5,13414,1548,14962,"Alaskan Flights"
"1925","2006",6,13897,1497,15394,"Alaskan Flights"
"1926","2006",7,14514,1601,16115,"Alaskan Flights"
"1927","2006",8,14612,1604,16216,"Alaskan Flights"
"1928","2006",9,13180,1433,14613,"Alaskan Flights"
"1929","2006",10,13165,1541,14706,"Alaskan Flights"
"1930","2006",11,12287,1970,14257,"Alaskan Flights"
"1931","2006",12,12708,2062,14770,"Alaskan Flights"
"1932","2007",1,12468,2044,14512,"Alaskan Flights"
"1933","2007",2,11492,1843,13335,"Alaskan Flights"
"1934","2007",3,12812,2059,14871,"Alaskan Flights"
"1935","2007",4,12658,1962,14620,"Alaskan Flights"
"1936","2007",5,13968,1581,15549,"Alaskan Flights"
"1937","2007",6,14179,1539,15718,"Alaskan Flights"
"1938","2007",7,14648,1537,16185,"Alaskan Flights"
"1939","2007",8,14611,1532,16143,"Alaskan Flights"
"1940","2007",9,13376,1441,14817,"Alaskan Flights"
"1941","2007",10,13231,1532,14763,"Alaskan Flights"
"1942","2007",11,12262,1820,14082,"Alaskan Flights"
"1943","2007",12,12769,1884,14653,"Alaskan Flights"
"1944","2008",1,12506,1870,14376,"Alaskan Flights"
"1945","2008",2,11795,1753,13548,"Alaskan Flights"
"1946","2008",3,12804,1881,14685,"Alaskan Flights"
"1947","2008",4,12471,1768,14239,"Alaskan Flights"
"1948","2008",5,13117,1454,14571,"Alaskan Flights"
"1949","2008",6,13388,1291,14679,"Alaskan Flights"
"1950","2008",7,14200,1255,15455,"Alaskan Flights"
"1951","2008",8,13738,1176,14914,"Alaskan Flights"
"1952","2008",9,12112,913,13025,"Alaskan Flights"
"1953","2008",10,12306,952,13258,"Alaskan Flights"
"1954","2008",11,11061,1174,12235,"Alaskan Flights"
"1955","2008",12,10847,1258,12105,"Alaskan Flights"
"1956","2009",1,11071,1276,12347,"Alaskan Flights"
"1957","2009",2,10183,1142,11325,"Alaskan Flights"
"1958","2009",3,11114,1264,12378,"Alaskan Flights"
"1959","2009",4,11029,1226,12255,"Alaskan Flights"
"1960","2009",5,11809,1004,12813,"Alaskan Flights"
"1961","2009",6,12127,926,13053,"Alaskan Flights"
"1962","2009",7,12760,761,13521,"Alaskan Flights"
"1963","2009",8,12618,744,13362,"Alaskan Flights"
"1964","2009",9,11222,685,11907,"Alaskan Flights"
"1965","2009",10,11409,724,12133,"Alaskan Flights"
"1966","2009",11,10415,1082,11497,"Alaskan Flights"
"1967","2009",12,10716,1252,11968,"Alaskan Flights"
"1968","2010",1,10482,1215,11697,"Alaskan Flights"
"1969","2010",2,9482,1056,10538,"Alaskan Flights"
"1970","2010",3,10914,1183,12097,"Alaskan Flights"
"1971","2010",4,10730,1173,11903,"Alaskan Flights"
"1972","2010",5,11584,1007,12591,"Alaskan Flights"
"1973","2010",6,12339,845,13184,"Alaskan Flights"
"1974","2010",7,12934,856,13790,"Alaskan Flights"
"1975","2010",8,12843,850,13693,"Alaskan Flights"
"1976","2010",9,11521,808,12329,"Alaskan Flights"
"1977","2010",10,11623,903,12526,"Alaskan Flights"
"1978","2010",11,11050,1106,12156,"Alaskan Flights"
"1979","2010",12,11465,1273,12738,"Alaskan Flights"
"1980","2011",1,11400,1251,12651,"Alaskan Flights"
"1981","2011",2,10355,1212,11567,"Alaskan Flights"
"1982","2011",3,11878,1367,13245,"Alaskan Flights"
"1983","2011",4,11703,1317,13020,"Alaskan Flights"
"1984","2011",5,12136,1086,13222,"Alaskan Flights"
"1985","2011",6,12836,991,13827,"Alaskan Flights"
"1986","2011",7,13304,1036,14340,"Alaskan Flights"
"1987","2011",8,13260,1018,14278,"Alaskan Flights"
"1988","2011",9,11806,960,12766,"Alaskan Flights"
"1989","2011",10,11894,998,12892,"Alaskan Flights"
"1990","2011",11,11193,1174,12367,"Alaskan Flights"
"1991","2011",12,11446,1253,12699,"Alaskan Flights"
"1992","2012",1,11017,1261,12278,"Alaskan Flights"
"1993","2012",2,10753,1181,11934,"Alaskan Flights"
"1994","2012",3,12020,1323,13343,"Alaskan Flights"
"1995","2012",4,11899,1243,13142,"Alaskan Flights"
"1996","2012",5,12610,1041,13651,"Alaskan Flights"
"1997","2012",6,13278,957,14235,"Alaskan Flights"
"1998","2012",7,13816,974,14790,"Alaskan Flights"
"1999","2012",8,13655,958,14613,"Alaskan Flights"
"2000","2012",9,11941,898,12839,"Alaskan Flights"
"2001","2012",10,11947,990,12937,"Alaskan Flights"
"2002","2012",11,11723,1066,12789,"Alaskan Flights"
"2003","2012",12,11997,1196,13193,"Alaskan Flights"
"2004","2013",1,11985,1198,13183,"Alaskan Flights"
"2005","2013",2,10869,1086,11955,"Alaskan Flights"
"2006","2013",3,12662,1297,13959,"Alaskan Flights"
"2007","2013",4,12562,1204,13766,"Alaskan Flights"
"2008","2013",5,13061,1067,14128,"Alaskan Flights"
"2009","2013",6,13988,1083,15071,"Alaskan Flights"
"2010","2013",7,14730,1116,15846,"Alaskan Flights"
"2011","2013",8,14505,1090,15595,"Alaskan Flights"
"2012","2013",9,12632,892,13524,"Alaskan Flights"
"2013","2013",10,12639,948,13587,"Alaskan Flights"
"2014","2013",11,12299,1181,13480,"Alaskan Flights"
"2015","2013",12,12527,1182,13709,"Alaskan Flights"
"2016","2014",1,12277,1210,13487,"Alaskan Flights"
"2017","2014",2,11230,1094,12324,"Alaskan Flights"
"2018","2014",3,12907,1249,14156,"Alaskan Flights"
"2019","2014",4,12666,1206,13872,"Alaskan Flights"
"2020","2014",5,13228,1041,14269,"Alaskan Flights"
"2021","2014",6,14156,1086,15242,"Alaskan Flights"
"2022","2014",7,14984,1136,16120,"Alaskan Flights"
"2023","2014",8,15086,1061,16147,"Alaskan Flights"
"2024","2014",9,13282,669,13951,"Alaskan Flights"
"2025","2014",10,13386,657,14043,"Alaskan Flights"
"2026","2014",11,13038,1052,14090,"Alaskan Flights"
"2027","2014",12,13598,1182,14780,"Alaskan Flights"
"2028","2015",1,13231,1136,14367,"Alaskan Flights"
"2029","2015",2,12139,980,13119,"Alaskan Flights"
"2030","2015",3,14303,1180,15483,"Alaskan Flights"
"2031","2015",4,13942,1078,15020,"Alaskan Flights"
"2032","2015",5,14672,831,15503,"Alaskan Flights"
"2033","2015",6,15039,781,15820,"Alaskan Flights"
"2034","2015",7,15814,772,16586,"Alaskan Flights"
"2035","2015",8,16089,794,16883,"Alaskan Flights"
"2036","2015",9,14257,703,14960,"Alaskan Flights"
"2037","2015",10,14458,845,15303,"Alaskan Flights"
"2038","2015",11,13956,1139,15095,"Alaskan Flights"
"2039","2015",12,14469,1256,15725,"Alaskan Flights"
"2040","2016",1,14113,1253,15366,"Alaskan Flights"
"2041","2016",2,13382,1150,14532,"Alaskan Flights"
"2042","2016",3,14761,1268,16029,"Alaskan Flights"
"2043","2016",4,14673,1132,15805,"Alaskan Flights"
"2044","2016",5,15396,890,16286,"Alaskan Flights"
"2045","2016",6,15737,934,16671,"Alaskan Flights"
"2046","2016",7,16271,992,17263,"Alaskan Flights"
"2047","2016",8,16519,963,17482,"Alaskan Flights"
"2048","2016",9,13873,920,14793,"Alaskan Flights"
"2049","2016",10,14059,1118,15177,"Alaskan Flights"
"2050","2016",11,13953,1230,15183,"Alaskan Flights"
"2051","2016",12,14409,1394,15803,"Alaskan Flights"
"2052","2017",1,14525,1399,15924,"Alaskan Flights"
"2053","2017",2,13108,1281,14389,"Alaskan Flights"
"2054","2017",3,15379,1492,16871,"Alaskan Flights"
"2055","2017",4,15239,1360,16599,"Alaskan Flights"
"2056","2017",5,16068,1112,17180,"Alaskan Flights"
"2057","2017",6,16340,1120,17460,"Alaskan Flights"
"2058","2017",7,17011,1147,18158,"Alaskan Flights"
"2059","2017",8,16733,1173,17906,"Alaskan Flights"
"2060","2017",9,14861,1077,15938,"Alaskan Flights"
"2061","2017",10,15048,1211,16259,"Alaskan Flights"
"2062","2017",11,14535,1283,15818,"Alaskan Flights"
"2063","2017",12,15303,1439,16742,"Alaskan Flights"
"2064","2018",1,15205,1358,16563,"Alaskan Flights"
"2065","2018",2,13989,1194,15183,"Alaskan Flights"
"2066","2018",3,15862,1358,17220,"Alaskan Flights"
"2067","2018",4,21911,1386,23297,"Alaskan Flights"
"2068","2018",5,22880,1214,24094,"Alaskan Flights"
"2069","2018",6,23071,1190,24261,"Alaskan Flights"
"2070","2018",7,24210,1215,25425,"Alaskan Flights"
"2071","2018",8,23436,1114,24550,"Alaskan Flights"
"2072","2018",9,20988,921,21909,"Alaskan Flights"
"2073","2018",10,21505,1048,22553,"Alaskan Flights"
"2074","2018",11,20355,1300,21655,"Alaskan Flights"
"2075","2018",12,20709,1365,22074,"Alaskan Flights"
"2076","2019",1,20395,1297,21692,"Alaskan Flights"
"2077","2019",2,18234,1198,19432,"Alaskan Flights"
"2078","2019",3,21464,1366,22830,"Alaskan Flights"
"2079","2019",4,21183,1290,22473,"Alaskan Flights"
"2080","2019",5,22497,964,23461,"Alaskan Flights"
"2081","2019",6,23111,1008,24119,"Alaskan Flights"
"2082","2019",7,24531,1029,25560,"Alaskan Flights"
"2083","2019",8,24526,913,25439,"Alaskan Flights"
"2084","2019",9,21659,719,22378,"Alaskan Flights"
"2085","2019",10,22113,879,22992,"Alaskan Flights"
"2086","2019",11,20878,1231,22109,"Alaskan Flights"
"2087","2019",12,21813,1349,23162,"Alaskan Flights"
"2088","2020",1,20876,1250,22126,"Alaskan Flights"
"2089","2020",2,19369,1227,20596,"Alaskan Flights"
"2090","2020",3,18450,1253,19703,"Alaskan Flights"
"2091","2020",4,4539,230,4769,"Alaskan Flights"
"2092","2020",5,4389,148,4537,"Alaskan Flights"
"2093","2020",6,6408,280,6688,"Alaskan Flights"
"2094","2020",7,7618,364,7982,"Alaskan Flights"
"2095","2020",8,9581,612,10193,"Alaskan Flights"
"2096","2020",9,9593,455,10048,"Alaskan Flights"
"2097","2020",10,10648,889,11537,"Alaskan Flights"
"2098","2020",11,10659,1012,11671,"Alaskan Flights"
"2099","2020",12,10870,1211,12081,"Alaskan Flights"
"2100","2021",1,10568,1362,11930,"Alaskan Flights"
"2101","2021",2,10704,1044,11748,"Alaskan Flights"
"2102","2021",3,14336,950,15286,"Alaskan Flights"
"2103","2021",4,15032,1011,16043,"Alaskan Flights"
"2104","2021",5,16009,1039,17048,"Alaskan Flights"
"2105","2021",6,16755,926,17681,"Alaskan Flights"
"2106","2021",7,17305,966,18271,"Alaskan Flights"
"2107","2021",8,17808,865,18673,"Alaskan Flights"
"2108","2021",9,17337,734,18071,"Alaskan Flights"
"2109","2021",10,17683,1111,18794,"Alaskan Flights"
"2110","2021",11,16700,1294,17994,"Alaskan Flights"
"2111","2021",12,15957,1615,17572,"Alaskan Flights"
"2112","2022",1,15330,1434,16764,"Alaskan Flights"
"2113","2022",2,15775,1242,17017,"Alaskan Flights"
"2114","2022",3,18577,1394,19971,"Alaskan Flights"
"2115","2022",4,18386,1316,19702,"Alaskan Flights"
"2116","2022",5,18947,1125,20072,"Alaskan Flights"
"2117","2022",6,18817,959,19776,"Alaskan Flights"
"2118","2022",7,20340,987,21327,"Alaskan Flights"
"2119","2022",8,20444,931,21375,"Alaskan Flights"
"2120","2022",9,19653,828,20481,"Alaskan Flights"
"2121","2022",10,19574,848,20422,"Alaskan Flights"
"2122","2022",11,18573,1071,19644,"Alaskan Flights"
"2123","2022",12,18454,1315,19769,"Alaskan Flights"
"2124","2023",1,19602,1361,20963,"Alaskan Flights"
"2125","2023",2,17425,1218,18643,"Alaskan Flights"
"2126","2023",3,19841,1397,21238,"Alaskan Flights"
"2127","2023",4,19412,1445,20857,"Alaskan Flights"
"2128","2023",5,20597,1200,21797,"Alaskan Flights"
"2129","2023",6,21338,1127,22465,"Alaskan Flights"
"2130","2023",7,22700,1238,23938,"Alaskan Flights"
"2131","2023",8,22958,1066,24024,"Alaskan Flights"
"2132","2023",9,21391,852,22243,"Alaskan Flights"
"2133","2023",10,20302,1104,21406,"Alaskan Flights"
"2134","2023",11,19221,1480,20701,"Alaskan Flights"
"2135","2023",12,19331,2048,21379,"Alaskan Flights"
"2136","2024",1,14850,1965,16815,"Alaskan Flights"
"2137","2024",2,16796,2000,18796,"Alaskan Flights"
"2138","2024",3,19549,2143,21692,"Alaskan Flights"
"2139","2024",4,19359,1715,21074,"Alaskan Flights"
"2140","2024",5,21181,1292,22473,"Alaskan Flights"
"2141","2024",6,22049,1250,23299,"Alaskan Flights"
"2142","2024",7,23714,1279,24993,"Alaskan Flights"
"2143","2024",8,23078,1127,24205,"Alaskan Flights"
"2144","2024",9,21453,784,22237,"Alaskan Flights"
"2145","2024",10,20365,1339,21704,"Alaskan Flights"
"2146","2024",11,19388,1865,21253,"Alaskan Flights"
"2147","2024",12,19970,2140,22110,"Alaskan Flights"
"2148","2025",1,17965,2062,20027,"Alaskan Flights"
"2149",NA,NA,NA,NA,NA,"Alaskan Flights"
"2150","Note: All numbers are for scheduled services.",NA,NA,NA,NA,"Alaskan Flights"
"2151",NA,NA,NA,NA,NA,"Alaskan Flights"
"2152","SOURCE: Bureau of Transportation Statistics T-100 Segment data.",NA,NA,NA,NA,"Alaskan Flights"
